K-mer	R-C	Total
GGCAGATTCCCCCTAGACCCG	CGGGTCTAGGGGGAATCTGCC	1
GCAGATTCCCCCTAGACCCGC	GCGGGTCTAGGGGGAATCTGC	1
CAGATTCCCCCTAGACCCGCC	GGCGGGTCTAGGGGGAATCTG	1
AGATTCCCCCTAGACCCGCCC	GGGCGGGTCTAGGGGGAATCT	1
GATTCCCCCTAGACCCGCCCG	CGGGCGGGTCTAGGGGGAATC	1
ATTCCCCCTAGACCCGCCCGC	GCGGGCGGGTCTAGGGGGAAT	1
TTCCCCCTAGACCCGCCCGCA	TGCGGGCGGGTCTAGGGGGAA	1
TCCCCCTAGACCCGCCCGCAC	GTGCGGGCGGGTCTAGGGGGA	1
CCCCCTAGACCCGCCCGCACC	GGTGCGGGCGGGTCTAGGGGG	1
CCCCTAGACCCGCCCGCACCA	TGGTGCGGGCGGGTCTAGGGG	1
CCCTAGACCCGCCCGCACCAT	ATGGTGCGGGCGGGTCTAGGG	1
CCTAGACCCGCCCGCACCATG	CATGGTGCGGGCGGGTCTAGG	1
CTAGACCCGCCCGCACCATGG	CCATGGTGCGGGCGGGTCTAG	1
TAGACCCGCCCGCACCATGGT	ACCATGGTGCGGGCGGGTCTA	1
AGACCCGCCCGCACCATGGTC	GACCATGGTGCGGGCGGGTCT	1
GACCCGCCCGCACCATGGTCA	TGACCATGGTGCGGGCGGGTC	1
ACCCGCCCGCACCATGGTCAG	CTGACCATGGTGCGGGCGGGT	1
CCCGCCCGCACCATGGTCAGG	CCTGACCATGGTGCGGGCGGG	1
CCGCCCGCACCATGGTCAGGC	GCCTGACCATGGTGCGGGCGG	1
CGCCCGCACCATGGTCAGGCA	TGCCTGACCATGGTGCGGGCG	1
GCCCGCACCATGGTCAGGCAT	ATGCCTGACCATGGTGCGGGC	1
CCCGCACCATGGTCAGGCATG	CATGCCTGACCATGGTGCGGG	1
CCGCACCATGGTCAGGCATGC	GCATGCCTGACCATGGTGCGG	1
CGCACCATGGTCAGGCATGCC	GGCATGCCTGACCATGGTGCG	1
GCACCATGGTCAGGCATGCCC	GGGCATGCCTGACCATGGTGC	1
CACCATGGTCAGGCATGCCCC	GGGGCATGCCTGACCATGGTG	1
ACCATGGTCAGGCATGCCCCT	AGGGGCATGCCTGACCATGGT	1
CCATGGTCAGGCATGCCCCTC	GAGGGGCATGCCTGACCATGG	1
CATGGTCAGGCATGCCCCTCC	GGAGGGGCATGCCTGACCATG	1
ATGGTCAGGCATGCCCCTCCT	AGGAGGGGCATGCCTGACCAT	1
TGGTCAGGCATGCCCCTCCTC	GAGGAGGGGCATGCCTGACCA	1
GGTCAGGCATGCCCCTCCTCA	TGAGGAGGGGCATGCCTGACC	1
GTCAGGCATGCCCCTCCTCAT	ATGAGGAGGGGCATGCCTGAC	1
TCAGGCATGCCCCTCCTCATC	GATGAGGAGGGGCATGCCTGA	1
CAGGCATGCCCCTCCTCATCG	CGATGAGGAGGGGCATGCCTG	1
AGGCATGCCCCTCCTCATCGC	GCGATGAGGAGGGGCATGCCT	1
GGCATGCCCCTCCTCATCGCT	AGCGATGAGGAGGGGCATGCC	1
GCATGCCCCTCCTCATCGCTG	CAGCGATGAGGAGGGGCATGC	1
CATGCCCCTCCTCATCGCTGG	CCAGCGATGAGGAGGGGCATG	1
ATGCCCCTCCTCATCGCTGGG	CCCAGCGATGAGGAGGGGCAT	1
TGCCCCTCCTCATCGCTGGGC	GCCCAGCGATGAGGAGGGGCA	1
GCCCCTCCTCATCGCTGGGCA	TGCCCAGCGATGAGGAGGGGC	1
CCCCTCCTCATCGCTGGGCAC	GTGCCCAGCGATGAGGAGGGG	1
CCCTCCTCATCGCTGGGCACA	TGTGCCCAGCGATGAGGAGGG	1
CCTCCTCATCGCTGGGCACAG	CTGTGCCCAGCGATGAGGAGG	1
CTCCTCATCGCTGGGCACAGC	GCTGTGCCCAGCGATGAGGAG	1
TCCTCATCGCTGGGCACAGCC	GGCTGTGCCCAGCGATGAGGA	1
CCTCATCGCTGGGCACAGCCC	GGGCTGTGCCCAGCGATGAGG	1
CTCATCGCTGGGCACAGCCCA	TGGGCTGTGCCCAGCGATGAG	1
TCATCGCTGGGCACAGCCCAG	CTGGGCTGTGCCCAGCGATGA	1
CATCGCTGGGCACAGCCCAGA	TCTGGGCTGTGCCCAGCGATG	1
ATCGCTGGGCACAGCCCAGAG	CTCTGGGCTGTGCCCAGCGAT	1
TCGCTGGGCACAGCCCAGAGG	CCTCTGGGCTGTGCCCAGCGA	1
CGCTGGGCACAGCCCAGAGGG	CCCTCTGGGCTGTGCCCAGCG	1
GCTGGGCACAGCCCAGAGGGT	ACCCTCTGGGCTGTGCCCAGC	1
CTGGGCACAGCCCAGAGGGTA	TACCCTCTGGGCTGTGCCCAG	1
TGGGCACAGCCCAGAGGGTAT	ATACCCTCTGGGCTGTGCCCA	1
GGGCACAGCCCAGAGGGTATA	TATACCCTCTGGGCTGTGCCC	1
GGCACAGCCCAGAGGGTATAA	TTATACCCTCTGGGCTGTGCC	1
GCACAGCCCAGAGGGTATAAA	TTTATACCCTCTGGGCTGTGC	1
CACAGCCCAGAGGGTATAAAC	GTTTATACCCTCTGGGCTGTG	1
ACAGCCCAGAGGGTATAAACA	TGTTTATACCCTCTGGGCTGT	1
CAGCCCAGAGGGTATAAACAG	CTGTTTATACCCTCTGGGCTG	1
AGCCCAGAGGGTATAAACAGT	ACTGTTTATACCCTCTGGGCT	1
GCCCAGAGGGTATAAACAGTG	CACTGTTTATACCCTCTGGGC	1
CCCAGAGGGTATAAACAGTGC	GCACTGTTTATACCCTCTGGG	1
CCAGAGGGTATAAACAGTGCT	AGCACTGTTTATACCCTCTGG	1
CAGAGGGTATAAACAGTGCTG	CAGCACTGTTTATACCCTCTG	1
AGAGGGTATAAACAGTGCTGG	CCAGCACTGTTTATACCCTCT	1
GAGGGTATAAACAGTGCTGGA	TCCAGCACTGTTTATACCCTC	1
AGGGTATAAACAGTGCTGGAG	CTCCAGCACTGTTTATACCCT	1
GGGTATAAACAGTGCTGGAGG	CCTCCAGCACTGTTTATACCC	1
GGTATAAACAGTGCTGGAGGC	GCCTCCAGCACTGTTTATACC	1
GTATAAACAGTGCTGGAGGCT	AGCCTCCAGCACTGTTTATAC	1
TATAAACAGTGCTGGAGGCTG	CAGCCTCCAGCACTGTTTATA	1
ATAAACAGTGCTGGAGGCTGG	CCAGCCTCCAGCACTGTTTAT	1
TAAACAGTGCTGGAGGCTGGC	GCCAGCCTCCAGCACTGTTTA	1
AAACAGTGCTGGAGGCTGGCG	CGCCAGCCTCCAGCACTGTTT	1
AACAGTGCTGGAGGCTGGCGG	CCGCCAGCCTCCAGCACTGTT	1
ACAGTGCTGGAGGCTGGCGGG	CCCGCCAGCCTCCAGCACTGT	1
CAGTGCTGGAGGCTGGCGGGG	CCCCGCCAGCCTCCAGCACTG	1
AGTGCTGGAGGCTGGCGGGGC	GCCCCGCCAGCCTCCAGCACT	1
GTGCTGGAGGCTGGCGGGGCA	TGCCCCGCCAGCCTCCAGCAC	1
TGCTGGAGGCTGGCGGGGCAG	CTGCCCCGCCAGCCTCCAGCA	1
GCTGGAGGCTGGCGGGGCAGG	CCTGCCCCGCCAGCCTCCAGC	1
CTGGAGGCTGGCGGGGCAGGC	GCCTGCCCCGCCAGCCTCCAG	1
TGGAGGCTGGCGGGGCAGGCC	GGCCTGCCCCGCCAGCCTCCA	1
GGAGGCTGGCGGGGCAGGCCA	TGGCCTGCCCCGCCAGCCTCC	1
GAGGCTGGCGGGGCAGGCCAG	CTGGCCTGCCCCGCCAGCCTC	1
AGGCTGGCGGGGCAGGCCAGC	GCTGGCCTGCCCCGCCAGCCT	1
GGCTGGCGGGGCAGGCCAGCT	AGCTGGCCTGCCCCGCCAGCC	1
GCTGGCGGGGCAGGCCAGCTG	CAGCTGGCCTGCCCCGCCAGC	1
CTGGCGGGGCAGGCCAGCTGA	TCAGCTGGCCTGCCCCGCCAG	1
TGGCGGGGCAGGCCAGCTGAG	CTCAGCTGGCCTGCCCCGCCA	1
GGCGGGGCAGGCCAGCTGAGT	ACTCAGCTGGCCTGCCCCGCC	1
GCGGGGCAGGCCAGCTGAGTC	GACTCAGCTGGCCTGCCCCGC	1
CGGGGCAGGCCAGCTGAGTCC	GGACTCAGCTGGCCTGCCCCG	1
GGGGCAGGCCAGCTGAGTCCT	AGGACTCAGCTGGCCTGCCCC	1
GGGCAGGCCAGCTGAGTCCTG	CAGGACTCAGCTGGCCTGCCC	1
GGCAGGCCAGCTGAGTCCTGA	TCAGGACTCAGCTGGCCTGCC	1
GCAGGCCAGCTGAGTCCTGAG	CTCAGGACTCAGCTGGCCTGC	1
CAGGCCAGCTGAGTCCTGAGC	GCTCAGGACTCAGCTGGCCTG	1
AGGCCAGCTGAGTCCTGAGCA	TGCTCAGGACTCAGCTGGCCT	1
GGCCAGCTGAGTCCTGAGCAG	CTGCTCAGGACTCAGCTGGCC	1
GCCAGCTGAGTCCTGAGCAGC	GCTGCTCAGGACTCAGCTGGC	1
CCAGCTGAGTCCTGAGCAGCA	TGCTGCTCAGGACTCAGCTGG	1
CAGCTGAGTCCTGAGCAGCAG	CTGCTGCTCAGGACTCAGCTG	1
AGCTGAGTCCTGAGCAGCAGC	GCTGCTGCTCAGGACTCAGCT	1
GCTGAGTCCTGAGCAGCAGCC	GGCTGCTGCTCAGGACTCAGC	1
CTGAGTCCTGAGCAGCAGCCC	GGGCTGCTGCTCAGGACTCAG	1
TGAGTCCTGAGCAGCAGCCCA	TGGGCTGCTGCTCAGGACTCA	1
GAGTCCTGAGCAGCAGCCCAG	CTGGGCTGCTGCTCAGGACTC	1
AGTCCTGAGCAGCAGCCCAGC	GCTGGGCTGCTGCTCAGGACT	1
GTCCTGAGCAGCAGCCCAGCG	CGCTGGGCTGCTGCTCAGGAC	1
TCCTGAGCAGCAGCCCAGCGC	GCGCTGGGCTGCTGCTCAGGA	1
CCTGAGCAGCAGCCCAGCGCA	TGCGCTGGGCTGCTGCTCAGG	1
CTGAGCAGCAGCCCAGCGCAG	CTGCGCTGGGCTGCTGCTCAG	1
TGAGCAGCAGCCCAGCGCAGC	GCTGCGCTGGGCTGCTGCTCA	1
GAGCAGCAGCCCAGCGCAGCC	GGCTGCGCTGGGCTGCTGCTC	1
AGCAGCAGCCCAGCGCAGCCA	TGGCTGCGCTGGGCTGCTGCT	1
GCAGCAGCCCAGCGCAGCCAC	GTGGCTGCGCTGGGCTGCTGC	1
CAGCAGCCCAGCGCAGCCACC	GGTGGCTGCGCTGGGCTGCTG	1
AGCAGCCCAGCGCAGCCACCG	CGGTGGCTGCGCTGGGCTGCT	1
GCAGCCCAGCGCAGCCACCGA	TCGGTGGCTGCGCTGGGCTGC	1
CAGCCCAGCGCAGCCACCGAG	CTCGGTGGCTGCGCTGGGCTG	1
AGCCCAGCGCAGCCACCGAGA	TCTCGGTGGCTGCGCTGGGCT	1
GCCCAGCGCAGCCACCGAGAC	GTCTCGGTGGCTGCGCTGGGC	1
CCCAGCGCAGCCACCGAGACA	TGTCTCGGTGGCTGCGCTGGG	1
CCAGCGCAGCCACCGAGACAC	GTGTCTCGGTGGCTGCGCTGG	1
CAGCGCAGCCACCGAGACACC	GGTGTCTCGGTGGCTGCGCTG	1
AGCGCAGCCACCGAGACACCA	TGGTGTCTCGGTGGCTGCGCT	1
GCGCAGCCACCGAGACACCAT	ATGGTGTCTCGGTGGCTGCGC	1
CGCAGCCACCGAGACACCATG	CATGGTGTCTCGGTGGCTGCG	1
GCAGCCACCGAGACACCATGA	TCATGGTGTCTCGGTGGCTGC	1
CAGCCACCGAGACACCATGAG	CTCATGGTGTCTCGGTGGCTG	1
AGCCACCGAGACACCATGAGA	TCTCATGGTGTCTCGGTGGCT	1
GCCACCGAGACACCATGAGAG	CTCTCATGGTGTCTCGGTGGC	1
CCACCGAGACACCATGAGAGC	GCTCTCATGGTGTCTCGGTGG	1
CACCGAGACACCATGAGAGCC	GGCTCTCATGGTGTCTCGGTG	1
ACCGAGACACCATGAGAGCCC	GGGCTCTCATGGTGTCTCGGT	1
CCGAGACACCATGAGAGCCCT	AGGGCTCTCATGGTGTCTCGG	1
CGAGACACCATGAGAGCCCTC	GAGGGCTCTCATGGTGTCTCG	1
GAGACACCATGAGAGCCCTCA	TGAGGGCTCTCATGGTGTCTC	1
AGACACCATGAGAGCCCTCAC	GTGAGGGCTCTCATGGTGTCT	1
GACACCATGAGAGCCCTCACA	TGTGAGGGCTCTCATGGTGTC	1
ACACCATGAGAGCCCTCACAC	GTGTGAGGGCTCTCATGGTGT	1
CACCATGAGAGCCCTCACACT	AGTGTGAGGGCTCTCATGGTG	1
ACCATGAGAGCCCTCACACTC	GAGTGTGAGGGCTCTCATGGT	1
CCATGAGAGCCCTCACACTCC	GGAGTGTGAGGGCTCTCATGG	1
CATGAGAGCCCTCACACTCCT	AGGAGTGTGAGGGCTCTCATG	1
ATGAGAGCCCTCACACTCCTC	GAGGAGTGTGAGGGCTCTCAT	1
TGAGAGCCCTCACACTCCTCG	CGAGGAGTGTGAGGGCTCTCA	1
GAGAGCCCTCACACTCCTCGC	GCGAGGAGTGTGAGGGCTCTC	1
AGAGCCCTCACACTCCTCGCC	GGCGAGGAGTGTGAGGGCTCT	1
GAGCCCTCACACTCCTCGCCC	GGGCGAGGAGTGTGAGGGCTC	1
AGCCCTCACACTCCTCGCCCT	AGGGCGAGGAGTGTGAGGGCT	1
GCCCTCACACTCCTCGCCCTA	TAGGGCGAGGAGTGTGAGGGC	1
CCCTCACACTCCTCGCCCTAT	ATAGGGCGAGGAGTGTGAGGG	1
CCTCACACTCCTCGCCCTATT	AATAGGGCGAGGAGTGTGAGG	1
CTCACACTCCTCGCCCTATTG	CAATAGGGCGAGGAGTGTGAG	1
TCACACTCCTCGCCCTATTGG	CCAATAGGGCGAGGAGTGTGA	1
CACACTCCTCGCCCTATTGGC	GCCAATAGGGCGAGGAGTGTG	1
ACACTCCTCGCCCTATTGGCC	GGCCAATAGGGCGAGGAGTGT	1
CACTCCTCGCCCTATTGGCCC	GGGCCAATAGGGCGAGGAGTG	1
ACTCCTCGCCCTATTGGCCCT	AGGGCCAATAGGGCGAGGAGT	1
CTCCTCGCCCTATTGGCCCTG	CAGGGCCAATAGGGCGAGGAG	1
TCCTCGCCCTATTGGCCCTGG	CCAGGGCCAATAGGGCGAGGA	1
CCTCGCCCTATTGGCCCTGGC	GCCAGGGCCAATAGGGCGAGG	1
CTCGCCCTATTGGCCCTGGCC	GGCCAGGGCCAATAGGGCGAG	1
TCGCCCTATTGGCCCTGGCCG	CGGCCAGGGCCAATAGGGCGA	1
CGCCCTATTGGCCCTGGCCGC	GCGGCCAGGGCCAATAGGGCG	1
GCCCTATTGGCCCTGGCCGCA	TGCGGCCAGGGCCAATAGGGC	1
CCCTATTGGCCCTGGCCGCAC	GTGCGGCCAGGGCCAATAGGG	1
CCTATTGGCCCTGGCCGCACT	AGTGCGGCCAGGGCCAATAGG	1
CTATTGGCCCTGGCCGCACTT	AAGTGCGGCCAGGGCCAATAG	1
TATTGGCCCTGGCCGCACTTT	AAAGTGCGGCCAGGGCCAATA	1
ATTGGCCCTGGCCGCACTTTG	CAAAGTGCGGCCAGGGCCAAT	1
TTGGCCCTGGCCGCACTTTGC	GCAAAGTGCGGCCAGGGCCAA	1
TGGCCCTGGCCGCACTTTGCA	TGCAAAGTGCGGCCAGGGCCA	1
GGCCCTGGCCGCACTTTGCAT	ATGCAAAGTGCGGCCAGGGCC	1
GCCCTGGCCGCACTTTGCATC	GATGCAAAGTGCGGCCAGGGC	1
CCCTGGCCGCACTTTGCATCG	CGATGCAAAGTGCGGCCAGGG	1
CCTGGCCGCACTTTGCATCGC	GCGATGCAAAGTGCGGCCAGG	1
CTGGCCGCACTTTGCATCGCT	AGCGATGCAAAGTGCGGCCAG	1
TGGCCGCACTTTGCATCGCTG	CAGCGATGCAAAGTGCGGCCA	1
GGCCGCACTTTGCATCGCTGG	CCAGCGATGCAAAGTGCGGCC	1
GCCGCACTTTGCATCGCTGGC	GCCAGCGATGCAAAGTGCGGC	1
CCGCACTTTGCATCGCTGGCC	GGCCAGCGATGCAAAGTGCGG	1
CGCACTTTGCATCGCTGGCCA	TGGCCAGCGATGCAAAGTGCG	1
GCACTTTGCATCGCTGGCCAG	CTGGCCAGCGATGCAAAGTGC	1
CACTTTGCATCGCTGGCCAGG	CCTGGCCAGCGATGCAAAGTG	1
ACTTTGCATCGCTGGCCAGGC	GCCTGGCCAGCGATGCAAAGT	1
CTTTGCATCGCTGGCCAGGCA	TGCCTGGCCAGCGATGCAAAG	1
TTTGCATCGCTGGCCAGGCAG	CTGCCTGGCCAGCGATGCAAA	1
TTGCATCGCTGGCCAGGCAGG	CCTGCCTGGCCAGCGATGCAA	1
TGCATCGCTGGCCAGGCAGGT	ACCTGCCTGGCCAGCGATGCA	1
GCATCGCTGGCCAGGCAGGTG	CACCTGCCTGGCCAGCGATGC	1
CATCGCTGGCCAGGCAGGTGA	TCACCTGCCTGGCCAGCGATG	1
ATCGCTGGCCAGGCAGGTGAG	CTCACCTGCCTGGCCAGCGAT	1
TCGCTGGCCAGGCAGGTGAGT	ACTCACCTGCCTGGCCAGCGA	1
CGCTGGCCAGGCAGGTGAGTG	CACTCACCTGCCTGGCCAGCG	1
GCTGGCCAGGCAGGTGAGTGC	GCACTCACCTGCCTGGCCAGC	1
CTGGCCAGGCAGGTGAGTGCC	GGCACTCACCTGCCTGGCCAG	1
TGGCCAGGCAGGTGAGTGCCC	GGGCACTCACCTGCCTGGCCA	1
GGCCAGGCAGGTGAGTGCCCC	GGGGCACTCACCTGCCTGGCC	1
GCCAGGCAGGTGAGTGCCCCC	GGGGGCACTCACCTGCCTGGC	1
CCAGGCAGGTGAGTGCCCCCA	TGGGGGCACTCACCTGCCTGG	1
CAGGCAGGTGAGTGCCCCCAC	GTGGGGGCACTCACCTGCCTG	1
AGGCAGGTGAGTGCCCCCACC	GGTGGGGGCACTCACCTGCCT	1
GGCAGGTGAGTGCCCCCACCT	AGGTGGGGGCACTCACCTGCC	1
GCAGGTGAGTGCCCCCACCTC	GAGGTGGGGGCACTCACCTGC	1
CAGGTGAGTGCCCCCACCTCC	GGAGGTGGGGGCACTCACCTG	1
AGGTGAGTGCCCCCACCTCCC	GGGAGGTGGGGGCACTCACCT	1
GGTGAGTGCCCCCACCTCCCC	GGGGAGGTGGGGGCACTCACC	1
GTGAGTGCCCCCACCTCCCCT	AGGGGAGGTGGGGGCACTCAC	1
TGAGTGCCCCCACCTCCCCTC	GAGGGGAGGTGGGGGCACTCA	1
GAGTGCCCCCACCTCCCCTCA	TGAGGGGAGGTGGGGGCACTC	1
AGTGCCCCCACCTCCCCTCAG	CTGAGGGGAGGTGGGGGCACT	1
GTGCCCCCACCTCCCCTCAGG	CCTGAGGGGAGGTGGGGGCAC	1
TGCCCCCACCTCCCCTCAGGC	GCCTGAGGGGAGGTGGGGGCA	1
GCCCCCACCTCCCCTCAGGCC	GGCCTGAGGGGAGGTGGGGGC	1
CCCCCACCTCCCCTCAGGCCG	CGGCCTGAGGGGAGGTGGGGG	1
CCCCACCTCCCCTCAGGCCGC	GCGGCCTGAGGGGAGGTGGGG	1
CCCACCTCCCCTCAGGCCGCA	TGCGGCCTGAGGGGAGGTGGG	1
CCACCTCCCCTCAGGCCGCAT	ATGCGGCCTGAGGGGAGGTGG	1
CACCTCCCCTCAGGCCGCATT	AATGCGGCCTGAGGGGAGGTG	1
ACCTCCCCTCAGGCCGCATTG	CAATGCGGCCTGAGGGGAGGT	1
CCTCCCCTCAGGCCGCATTGC	GCAATGCGGCCTGAGGGGAGG	1
CTCCCCTCAGGCCGCATTGCA	TGCAATGCGGCCTGAGGGGAG	1
TCCCCTCAGGCCGCATTGCAG	CTGCAATGCGGCCTGAGGGGA	1
CCCCTCAGGCCGCATTGCAGT	ACTGCAATGCGGCCTGAGGGG	1
CCCTCAGGCCGCATTGCAGTG	CACTGCAATGCGGCCTGAGGG	1
CCTCAGGCCGCATTGCAGTGG	CCACTGCAATGCGGCCTGAGG	1
CTCAGGCCGCATTGCAGTGGG	CCCACTGCAATGCGGCCTGAG	1
TCAGGCCGCATTGCAGTGGGG	CCCCACTGCAATGCGGCCTGA	1
CAGGCCGCATTGCAGTGGGGG	CCCCCACTGCAATGCGGCCTG	1
AGGCCGCATTGCAGTGGGGGC	GCCCCCACTGCAATGCGGCCT	1
GGCCGCATTGCAGTGGGGGCT	AGCCCCCACTGCAATGCGGCC	1
GCCGCATTGCAGTGGGGGCTG	CAGCCCCCACTGCAATGCGGC	1
CCGCATTGCAGTGGGGGCTGA	TCAGCCCCCACTGCAATGCGG	1
CGCATTGCAGTGGGGGCTGAG	CTCAGCCCCCACTGCAATGCG	1
GCATTGCAGTGGGGGCTGAGA	TCTCAGCCCCCACTGCAATGC	1
CATTGCAGTGGGGGCTGAGAG	CTCTCAGCCCCCACTGCAATG	1
ATTGCAGTGGGGGCTGAGAGG	CCTCTCAGCCCCCACTGCAAT	1
TTGCAGTGGGGGCTGAGAGGA	TCCTCTCAGCCCCCACTGCAA	1
TGCAGTGGGGGCTGAGAGGAG	CTCCTCTCAGCCCCCACTGCA	1
GCAGTGGGGGCTGAGAGGAGG	CCTCCTCTCAGCCCCCACTGC	1
CAGTGGGGGCTGAGAGGAGGA	TCCTCCTCTCAGCCCCCACTG	1
AGTGGGGGCTGAGAGGAGGAA	TTCCTCCTCTCAGCCCCCACT	1
GTGGGGGCTGAGAGGAGGAAG	CTTCCTCCTCTCAGCCCCCAC	1
TGGGGGCTGAGAGGAGGAAGC	GCTTCCTCCTCTCAGCCCCCA	1
GGGGGCTGAGAGGAGGAAGCA	TGCTTCCTCCTCTCAGCCCCC	1
GGGGCTGAGAGGAGGAAGCAC	GTGCTTCCTCCTCTCAGCCCC	1
GGGCTGAGAGGAGGAAGCACC	GGTGCTTCCTCCTCTCAGCCC	1
GGCTGAGAGGAGGAAGCACCA	TGGTGCTTCCTCCTCTCAGCC	1
GCTGAGAGGAGGAAGCACCAT	ATGGTGCTTCCTCCTCTCAGC	1
CTGAGAGGAGGAAGCACCATG	CATGGTGCTTCCTCCTCTCAG	1
TGAGAGGAGGAAGCACCATGG	CCATGGTGCTTCCTCCTCTCA	1
GAGAGGAGGAAGCACCATGGC	GCCATGGTGCTTCCTCCTCTC	1
AGAGGAGGAAGCACCATGGCC	GGCCATGGTGCTTCCTCCTCT	1
GAGGAGGAAGCACCATGGCCC	GGGCCATGGTGCTTCCTCCTC	1
AGGAGGAAGCACCATGGCCCA	TGGGCCATGGTGCTTCCTCCT	1
GGAGGAAGCACCATGGCCCAC	GTGGGCCATGGTGCTTCCTCC	1
GAGGAAGCACCATGGCCCACC	GGTGGGCCATGGTGCTTCCTC	1
AGGAAGCACCATGGCCCACCT	AGGTGGGCCATGGTGCTTCCT	1
GGAAGCACCATGGCCCACCTC	GAGGTGGGCCATGGTGCTTCC	1
GAAGCACCATGGCCCACCTCT	AGAGGTGGGCCATGGTGCTTC	1
AAGCACCATGGCCCACCTCTT	AAGAGGTGGGCCATGGTGCTT	1
AGCACCATGGCCCACCTCTTC	GAAGAGGTGGGCCATGGTGCT	1
GCACCATGGCCCACCTCTTCT	AGAAGAGGTGGGCCATGGTGC	1
CACCATGGCCCACCTCTTCTC	GAGAAGAGGTGGGCCATGGTG	1
ACCATGGCCCACCTCTTCTCA	TGAGAAGAGGTGGGCCATGGT	1
CCATGGCCCACCTCTTCTCAC	GTGAGAAGAGGTGGGCCATGG	1
CATGGCCCACCTCTTCTCACC	GGTGAGAAGAGGTGGGCCATG	1
ATGGCCCACCTCTTCTCACCC	GGGTGAGAAGAGGTGGGCCAT	1
TGGCCCACCTCTTCTCACCCC	GGGGTGAGAAGAGGTGGGCCA	1
GGCCCACCTCTTCTCACCCCT	AGGGGTGAGAAGAGGTGGGCC	1
GCCCACCTCTTCTCACCCCTT	AAGGGGTGAGAAGAGGTGGGC	1
CCCACCTCTTCTCACCCCTTT	AAAGGGGTGAGAAGAGGTGGG	1
CCACCTCTTCTCACCCCTTTG	CAAAGGGGTGAGAAGAGGTGG	1
CACCTCTTCTCACCCCTTTGG	CCAAAGGGGTGAGAAGAGGTG	1
ACCTCTTCTCACCCCTTTGGC	GCCAAAGGGGTGAGAAGAGGT	1
CCTCTTCTCACCCCTTTGGCT	AGCCAAAGGGGTGAGAAGAGG	1
CTCTTCTCACCCCTTTGGCTG	CAGCCAAAGGGGTGAGAAGAG	1
TCTTCTCACCCCTTTGGCTGG	CCAGCCAAAGGGGTGAGAAGA	1
CTTCTCACCCCTTTGGCTGGC	GCCAGCCAAAGGGGTGAGAAG	1
TTCTCACCCCTTTGGCTGGCA	TGCCAGCCAAAGGGGTGAGAA	1
TCTCACCCCTTTGGCTGGCAG	CTGCCAGCCAAAGGGGTGAGA	1
CTCACCCCTTTGGCTGGCAGT	ACTGCCAGCCAAAGGGGTGAG	1
TCACCCCTTTGGCTGGCAGTC	GACTGCCAGCCAAAGGGGTGA	1
CACCCCTTTGGCTGGCAGTCC	GGACTGCCAGCCAAAGGGGTG	1
ACCCCTTTGGCTGGCAGTCCC	GGGACTGCCAGCCAAAGGGGT	1
CCCCTTTGGCTGGCAGTCCCT	AGGGACTGCCAGCCAAAGGGG	1
CCCTTTGGCTGGCAGTCCCTT	AAGGGACTGCCAGCCAAAGGG	1
CCTTTGGCTGGCAGTCCCTTT	AAAGGGACTGCCAGCCAAAGG	1
CTTTGGCTGGCAGTCCCTTTG	CAAAGGGACTGCCAGCCAAAG	1
TTTGGCTGGCAGTCCCTTTGC	GCAAAGGGACTGCCAGCCAAA	1
TTGGCTGGCAGTCCCTTTGCA	TGCAAAGGGACTGCCAGCCAA	1
TGGCTGGCAGTCCCTTTGCAG	CTGCAAAGGGACTGCCAGCCA	1
GGCTGGCAGTCCCTTTGCAGT	ACTGCAAAGGGACTGCCAGCC	1
GCTGGCAGTCCCTTTGCAGTC	GACTGCAAAGGGACTGCCAGC	1
CTGGCAGTCCCTTTGCAGTCT	AGACTGCAAAGGGACTGCCAG	1
TGGCAGTCCCTTTGCAGTCTA	TAGACTGCAAAGGGACTGCCA	1
GGCAGTCCCTTTGCAGTCTAA	TTAGACTGCAAAGGGACTGCC	1
GCAGTCCCTTTGCAGTCTAAC	GTTAGACTGCAAAGGGACTGC	1
CAGTCCCTTTGCAGTCTAACC	GGTTAGACTGCAAAGGGACTG	1
AGTCCCTTTGCAGTCTAACCA	TGGTTAGACTGCAAAGGGACT	1
GTCCCTTTGCAGTCTAACCAC	GTGGTTAGACTGCAAAGGGAC	1
TCCCTTTGCAGTCTAACCACC	GGTGGTTAGACTGCAAAGGGA	1
CCCTTTGCAGTCTAACCACCT	AGGTGGTTAGACTGCAAAGGG	1
CCTTTGCAGTCTAACCACCTT	AAGGTGGTTAGACTGCAAAGG	1
CTTTGCAGTCTAACCACCTTG	CAAGGTGGTTAGACTGCAAAG	1
TTTGCAGTCTAACCACCTTGT	ACAAGGTGGTTAGACTGCAAA	1
TTGCAGTCTAACCACCTTGTT	AACAAGGTGGTTAGACTGCAA	1
TGCAGTCTAACCACCTTGTTG	CAACAAGGTGGTTAGACTGCA	1
GCAGTCTAACCACCTTGTTGC	GCAACAAGGTGGTTAGACTGC	1
CAGTCTAACCACCTTGTTGCA	TGCAACAAGGTGGTTAGACTG	1
AGTCTAACCACCTTGTTGCAG	CTGCAACAAGGTGGTTAGACT	1
GTCTAACCACCTTGTTGCAGG	CCTGCAACAAGGTGGTTAGAC	1
TCTAACCACCTTGTTGCAGGC	GCCTGCAACAAGGTGGTTAGA	1
CTAACCACCTTGTTGCAGGCT	AGCCTGCAACAAGGTGGTTAG	1
TAACCACCTTGTTGCAGGCTC	GAGCCTGCAACAAGGTGGTTA	1
AACCACCTTGTTGCAGGCTCA	TGAGCCTGCAACAAGGTGGTT	1
ACCACCTTGTTGCAGGCTCAA	TTGAGCCTGCAACAAGGTGGT	1
CCACCTTGTTGCAGGCTCAAT	ATTGAGCCTGCAACAAGGTGG	1
CACCTTGTTGCAGGCTCAATC	GATTGAGCCTGCAACAAGGTG	1
ACCTTGTTGCAGGCTCAATCC	GGATTGAGCCTGCAACAAGGT	1
CCTTGTTGCAGGCTCAATCCA	TGGATTGAGCCTGCAACAAGG	1
CTTGTTGCAGGCTCAATCCAT	ATGGATTGAGCCTGCAACAAG	1
TTGTTGCAGGCTCAATCCATT	AATGGATTGAGCCTGCAACAA	1
TGTTGCAGGCTCAATCCATTT	AAATGGATTGAGCCTGCAACA	1
GTTGCAGGCTCAATCCATTTG	CAAATGGATTGAGCCTGCAAC	1
TTGCAGGCTCAATCCATTTGC	GCAAATGGATTGAGCCTGCAA	1
TGCAGGCTCAATCCATTTGCC	GGCAAATGGATTGAGCCTGCA	1
GCAGGCTCAATCCATTTGCCC	GGGCAAATGGATTGAGCCTGC	1
CAGGCTCAATCCATTTGCCCC	GGGGCAAATGGATTGAGCCTG	1
AGGCTCAATCCATTTGCCCCA	TGGGGCAAATGGATTGAGCCT	1
GGCTCAATCCATTTGCCCCAG	CTGGGGCAAATGGATTGAGCC	1
GCTCAATCCATTTGCCCCAGC	GCTGGGGCAAATGGATTGAGC	1
CTCAATCCATTTGCCCCAGCT	AGCTGGGGCAAATGGATTGAG	1
TCAATCCATTTGCCCCAGCTC	GAGCTGGGGCAAATGGATTGA	1
CAATCCATTTGCCCCAGCTCT	AGAGCTGGGGCAAATGGATTG	1
AATCCATTTGCCCCAGCTCTG	CAGAGCTGGGGCAAATGGATT	1
ATCCATTTGCCCCAGCTCTGC	GCAGAGCTGGGGCAAATGGAT	1
TCCATTTGCCCCAGCTCTGCC	GGCAGAGCTGGGGCAAATGGA	1
CCATTTGCCCCAGCTCTGCCC	GGGCAGAGCTGGGGCAAATGG	1
CATTTGCCCCAGCTCTGCCCT	AGGGCAGAGCTGGGGCAAATG	1
ATTTGCCCCAGCTCTGCCCTT	AAGGGCAGAGCTGGGGCAAAT	1
TTTGCCCCAGCTCTGCCCTTG	CAAGGGCAGAGCTGGGGCAAA	1
TTGCCCCAGCTCTGCCCTTGC	GCAAGGGCAGAGCTGGGGCAA	1
TGCCCCAGCTCTGCCCTTGCA	TGCAAGGGCAGAGCTGGGGCA	1
GCCCCAGCTCTGCCCTTGCAG	CTGCAAGGGCAGAGCTGGGGC	1
CCCCAGCTCTGCCCTTGCAGA	TCTGCAAGGGCAGAGCTGGGG	1
CCCAGCTCTGCCCTTGCAGAG	CTCTGCAAGGGCAGAGCTGGG	1
CCAGCTCTGCCCTTGCAGAGG	CCTCTGCAAGGGCAGAGCTGG	1
CAGCTCTGCCCTTGCAGAGGG	CCCTCTGCAAGGGCAGAGCTG	1
AGCTCTGCCCTTGCAGAGGGA	TCCCTCTGCAAGGGCAGAGCT	1
GCTCTGCCCTTGCAGAGGGAG	CTCCCTCTGCAAGGGCAGAGC	1
CTCTGCCCTTGCAGAGGGAGA	TCTCCCTCTGCAAGGGCAGAG	1
TCTGCCCTTGCAGAGGGAGAG	CTCTCCCTCTGCAAGGGCAGA	1
CTGCCCTTGCAGAGGGAGAGG	CCTCTCCCTCTGCAAGGGCAG	1
TGCCCTTGCAGAGGGAGAGGA	TCCTCTCCCTCTGCAAGGGCA	1
GCCCTTGCAGAGGGAGAGGAG	CTCCTCTCCCTCTGCAAGGGC	1
CCCTTGCAGAGGGAGAGGAGG	CCTCCTCTCCCTCTGCAAGGG	1
CCTTGCAGAGGGAGAGGAGGG	CCCTCCTCTCCCTCTGCAAGG	1
CTTGCAGAGGGAGAGGAGGGA	TCCCTCCTCTCCCTCTGCAAG	1
TTGCAGAGGGAGAGGAGGGAA	TTCCCTCCTCTCCCTCTGCAA	1
TGCAGAGGGAGAGGAGGGAAG	CTTCCCTCCTCTCCCTCTGCA	1
GCAGAGGGAGAGGAGGGAAGA	TCTTCCCTCCTCTCCCTCTGC	1
CAGAGGGAGAGGAGGGAAGAG	CTCTTCCCTCCTCTCCCTCTG	1
AGAGGGAGAGGAGGGAAGAGC	GCTCTTCCCTCCTCTCCCTCT	1
GAGGGAGAGGAGGGAAGAGCA	TGCTCTTCCCTCCTCTCCCTC	1
AGGGAGAGGAGGGAAGAGCAA	TTGCTCTTCCCTCCTCTCCCT	1
GGGAGAGGAGGGAAGAGCAAG	CTTGCTCTTCCCTCCTCTCCC	1
GGAGAGGAGGGAAGAGCAAGC	GCTTGCTCTTCCCTCCTCTCC	1
GAGAGGAGGGAAGAGCAAGCT	AGCTTGCTCTTCCCTCCTCTC	1
AGAGGAGGGAAGAGCAAGCTG	CAGCTTGCTCTTCCCTCCTCT	1
GAGGAGGGAAGAGCAAGCTGC	GCAGCTTGCTCTTCCCTCCTC	1
AGGAGGGAAGAGCAAGCTGCC	GGCAGCTTGCTCTTCCCTCCT	1
GGAGGGAAGAGCAAGCTGCCC	GGGCAGCTTGCTCTTCCCTCC	1
GAGGGAAGAGCAAGCTGCCCG	CGGGCAGCTTGCTCTTCCCTC	1
AGGGAAGAGCAAGCTGCCCGA	TCGGGCAGCTTGCTCTTCCCT	1
GGGAAGAGCAAGCTGCCCGAG	CTCGGGCAGCTTGCTCTTCCC	1
GGAAGAGCAAGCTGCCCGAGA	TCTCGGGCAGCTTGCTCTTCC	1
GAAGAGCAAGCTGCCCGAGAC	GTCTCGGGCAGCTTGCTCTTC	1
AAGAGCAAGCTGCCCGAGACG	CGTCTCGGGCAGCTTGCTCTT	1
AGAGCAAGCTGCCCGAGACGC	GCGTCTCGGGCAGCTTGCTCT	1
GAGCAAGCTGCCCGAGACGCA	TGCGTCTCGGGCAGCTTGCTC	1
AGCAAGCTGCCCGAGACGCAG	CTGCGTCTCGGGCAGCTTGCT	1
GCAAGCTGCCCGAGACGCAGG	CCTGCGTCTCGGGCAGCTTGC	1
CAAGCTGCCCGAGACGCAGGG	CCCTGCGTCTCGGGCAGCTTG	1
AAGCTGCCCGAGACGCAGGGG	CCCCTGCGTCTCGGGCAGCTT	1
AGCTGCCCGAGACGCAGGGGA	TCCCCTGCGTCTCGGGCAGCT	1
GCTGCCCGAGACGCAGGGGAA	TTCCCCTGCGTCTCGGGCAGC	1
CTGCCCGAGACGCAGGGGAAG	CTTCCCCTGCGTCTCGGGCAG	1
TGCCCGAGACGCAGGGGAAGG	CCTTCCCCTGCGTCTCGGGCA	1
GCCCGAGACGCAGGGGAAGGA	TCCTTCCCCTGCGTCTCGGGC	1
CCCGAGACGCAGGGGAAGGAG	CTCCTTCCCCTGCGTCTCGGG	1
CCGAGACGCAGGGGAAGGAGG	CCTCCTTCCCCTGCGTCTCGG	1
CGAGACGCAGGGGAAGGAGGA	TCCTCCTTCCCCTGCGTCTCG	1
GAGACGCAGGGGAAGGAGGAT	ATCCTCCTTCCCCTGCGTCTC	1
AGACGCAGGGGAAGGAGGATG	CATCCTCCTTCCCCTGCGTCT	1
GACGCAGGGGAAGGAGGATGA	TCATCCTCCTTCCCCTGCGTC	1
ACGCAGGGGAAGGAGGATGAG	CTCATCCTCCTTCCCCTGCGT	1
CGCAGGGGAAGGAGGATGAGG	CCTCATCCTCCTTCCCCTGCG	1
GCAGGGGAAGGAGGATGAGGG	CCCTCATCCTCCTTCCCCTGC	1
CAGGGGAAGGAGGATGAGGGC	GCCCTCATCCTCCTTCCCCTG	1
AGGGGAAGGAGGATGAGGGCC	GGCCCTCATCCTCCTTCCCCT	1
GGGGAAGGAGGATGAGGGCCC	GGGCCCTCATCCTCCTTCCCC	1
GGGAAGGAGGATGAGGGCCCT	AGGGCCCTCATCCTCCTTCCC	1
GGAAGGAGGATGAGGGCCCTG	CAGGGCCCTCATCCTCCTTCC	1
GAAGGAGGATGAGGGCCCTGG	CCAGGGCCCTCATCCTCCTTC	1
AAGGAGGATGAGGGCCCTGGG	CCCAGGGCCCTCATCCTCCTT	1
AGGAGGATGAGGGCCCTGGGG	CCCCAGGGCCCTCATCCTCCT	1
GGAGGATGAGGGCCCTGGGGA	TCCCCAGGGCCCTCATCCTCC	1
GAGGATGAGGGCCCTGGGGAT	ATCCCCAGGGCCCTCATCCTC	1
AGGATGAGGGCCCTGGGGATG	CATCCCCAGGGCCCTCATCCT	1
GGATGAGGGCCCTGGGGATGA	TCATCCCCAGGGCCCTCATCC	1
GATGAGGGCCCTGGGGATGAG	CTCATCCCCAGGGCCCTCATC	1
ATGAGGGCCCTGGGGATGAGC	GCTCATCCCCAGGGCCCTCAT	1
TGAGGGCCCTGGGGATGAGCT	AGCTCATCCCCAGGGCCCTCA	1
GAGGGCCCTGGGGATGAGCTG	CAGCTCATCCCCAGGGCCCTC	1
AGGGCCCTGGGGATGAGCTGG	CCAGCTCATCCCCAGGGCCCT	1
GGGCCCTGGGGATGAGCTGGG	CCCAGCTCATCCCCAGGGCCC	1
GGCCCTGGGGATGAGCTGGGG	CCCCAGCTCATCCCCAGGGCC	1
GCCCTGGGGATGAGCTGGGGT	ACCCCAGCTCATCCCCAGGGC	1
CCCTGGGGATGAGCTGGGGTG	CACCCCAGCTCATCCCCAGGG	1
CCTGGGGATGAGCTGGGGTGA	TCACCCCAGCTCATCCCCAGG	1
CTGGGGATGAGCTGGGGTGAA	TTCACCCCAGCTCATCCCCAG	1
TGGGGATGAGCTGGGGTGAAC	GTTCACCCCAGCTCATCCCCA	1
GGGGATGAGCTGGGGTGAACC	GGTTCACCCCAGCTCATCCCC	1
GGGATGAGCTGGGGTGAACCA	TGGTTCACCCCAGCTCATCCC	1
GGATGAGCTGGGGTGAACCAG	CTGGTTCACCCCAGCTCATCC	1
GATGAGCTGGGGTGAACCAGG	CCTGGTTCACCCCAGCTCATC	1
ATGAGCTGGGGTGAACCAGGC	GCCTGGTTCACCCCAGCTCAT	1
TGAGCTGGGGTGAACCAGGCT	AGCCTGGTTCACCCCAGCTCA	1
GAGCTGGGGTGAACCAGGCTC	GAGCCTGGTTCACCCCAGCTC	1
AGCTGGGGTGAACCAGGCTCC	GGAGCCTGGTTCACCCCAGCT	1
GCTGGGGTGAACCAGGCTCCC	GGGAGCCTGGTTCACCCCAGC	1
CTGGGGTGAACCAGGCTCCCT	AGGGAGCCTGGTTCACCCCAG	1
TGGGGTGAACCAGGCTCCCTT	AAGGGAGCCTGGTTCACCCCA	1
GGGGTGAACCAGGCTCCCTTT	AAAGGGAGCCTGGTTCACCCC	1
GGGTGAACCAGGCTCCCTTTC	GAAAGGGAGCCTGGTTCACCC	1
GGTGAACCAGGCTCCCTTTCC	GGAAAGGGAGCCTGGTTCACC	1
GTGAACCAGGCTCCCTTTCCT	AGGAAAGGGAGCCTGGTTCAC	1
TGAACCAGGCTCCCTTTCCTT	AAGGAAAGGGAGCCTGGTTCA	1
GAACCAGGCTCCCTTTCCTTT	AAAGGAAAGGGAGCCTGGTTC	1
AACCAGGCTCCCTTTCCTTTG	CAAAGGAAAGGGAGCCTGGTT	1
ACCAGGCTCCCTTTCCTTTGC	GCAAAGGAAAGGGAGCCTGGT	1
CCAGGCTCCCTTTCCTTTGCA	TGCAAAGGAAAGGGAGCCTGG	1
CAGGCTCCCTTTCCTTTGCAG	CTGCAAAGGAAAGGGAGCCTG	1
AGGCTCCCTTTCCTTTGCAGG	CCTGCAAAGGAAAGGGAGCCT	1
GGCTCCCTTTCCTTTGCAGGT	ACCTGCAAAGGAAAGGGAGCC	1
GCTCCCTTTCCTTTGCAGGTG	CACCTGCAAAGGAAAGGGAGC	1
CTCCCTTTCCTTTGCAGGTGC	GCACCTGCAAAGGAAAGGGAG	1
TCCCTTTCCTTTGCAGGTGCG	CGCACCTGCAAAGGAAAGGGA	1
CCCTTTCCTTTGCAGGTGCGA	TCGCACCTGCAAAGGAAAGGG	1
CCTTTCCTTTGCAGGTGCGAA	TTCGCACCTGCAAAGGAAAGG	1
CTTTCCTTTGCAGGTGCGAAG	CTTCGCACCTGCAAAGGAAAG	1
TTTCCTTTGCAGGTGCGAAGC	GCTTCGCACCTGCAAAGGAAA	1
TTCCTTTGCAGGTGCGAAGCC	GGCTTCGCACCTGCAAAGGAA	1
TCCTTTGCAGGTGCGAAGCCC	GGGCTTCGCACCTGCAAAGGA	1
CCTTTGCAGGTGCGAAGCCCA	TGGGCTTCGCACCTGCAAAGG	1
CTTTGCAGGTGCGAAGCCCAG	CTGGGCTTCGCACCTGCAAAG	1
TTTGCAGGTGCGAAGCCCAGC	GCTGGGCTTCGCACCTGCAAA	1
TTGCAGGTGCGAAGCCCAGCG	CGCTGGGCTTCGCACCTGCAA	1
TGCAGGTGCGAAGCCCAGCGG	CCGCTGGGCTTCGCACCTGCA	1
GCAGGTGCGAAGCCCAGCGGT	ACCGCTGGGCTTCGCACCTGC	1
CAGGTGCGAAGCCCAGCGGTG	CACCGCTGGGCTTCGCACCTG	1
AGGTGCGAAGCCCAGCGGTGC	GCACCGCTGGGCTTCGCACCT	1
GGTGCGAAGCCCAGCGGTGCA	TGCACCGCTGGGCTTCGCACC	1
GTGCGAAGCCCAGCGGTGCAG	CTGCACCGCTGGGCTTCGCAC	1
TGCGAAGCCCAGCGGTGCAGA	TCTGCACCGCTGGGCTTCGCA	1
GCGAAGCCCAGCGGTGCAGAG	CTCTGCACCGCTGGGCTTCGC	1
CGAAGCCCAGCGGTGCAGAGT	ACTCTGCACCGCTGGGCTTCG	1
GAAGCCCAGCGGTGCAGAGTC	GACTCTGCACCGCTGGGCTTC	1
AAGCCCAGCGGTGCAGAGTCC	GGACTCTGCACCGCTGGGCTT	1
AGCCCAGCGGTGCAGAGTCCA	TGGACTCTGCACCGCTGGGCT	1
GCCCAGCGGTGCAGAGTCCAG	CTGGACTCTGCACCGCTGGGC	1
CCCAGCGGTGCAGAGTCCAGC	GCTGGACTCTGCACCGCTGGG	1
CCAGCGGTGCAGAGTCCAGCA	TGCTGGACTCTGCACCGCTGG	1
CAGCGGTGCAGAGTCCAGCAA	TTGCTGGACTCTGCACCGCTG	1
AGCGGTGCAGAGTCCAGCAAA	TTTGCTGGACTCTGCACCGCT	1
GCGGTGCAGAGTCCAGCAAAG	CTTTGCTGGACTCTGCACCGC	1
CGGTGCAGAGTCCAGCAAAGG	CCTTTGCTGGACTCTGCACCG	1
GGTGCAGAGTCCAGCAAAGGT	ACCTTTGCTGGACTCTGCACC	1
GTGCAGAGTCCAGCAAAGGTG	CACCTTTGCTGGACTCTGCAC	1
TGCAGAGTCCAGCAAAGGTGC	GCACCTTTGCTGGACTCTGCA	1
GCAGAGTCCAGCAAAGGTGCA	TGCACCTTTGCTGGACTCTGC	1
CAGAGTCCAGCAAAGGTGCAG	CTGCACCTTTGCTGGACTCTG	1
AGAGTCCAGCAAAGGTGCAGG	CCTGCACCTTTGCTGGACTCT	1
GAGTCCAGCAAAGGTGCAGGT	ACCTGCACCTTTGCTGGACTC	1
AGTCCAGCAAAGGTGCAGGTA	TACCTGCACCTTTGCTGGACT	1
GTCCAGCAAAGGTGCAGGTAT	ATACCTGCACCTTTGCTGGAC	1
TCCAGCAAAGGTGCAGGTATG	CATACCTGCACCTTTGCTGGA	1
CCAGCAAAGGTGCAGGTATGA	TCATACCTGCACCTTTGCTGG	1
CAGCAAAGGTGCAGGTATGAG	CTCATACCTGCACCTTTGCTG	1
AGCAAAGGTGCAGGTATGAGG	CCTCATACCTGCACCTTTGCT	1
GCAAAGGTGCAGGTATGAGGA	TCCTCATACCTGCACCTTTGC	1
CAAAGGTGCAGGTATGAGGAT	ATCCTCATACCTGCACCTTTG	1
AAAGGTGCAGGTATGAGGATG	CATCCTCATACCTGCACCTTT	1
AAGGTGCAGGTATGAGGATGG	CCATCCTCATACCTGCACCTT	1
AGGTGCAGGTATGAGGATGGA	TCCATCCTCATACCTGCACCT	1
GGTGCAGGTATGAGGATGGAC	GTCCATCCTCATACCTGCACC	1
GTGCAGGTATGAGGATGGACC	GGTCCATCCTCATACCTGCAC	1
TGCAGGTATGAGGATGGACCT	AGGTCCATCCTCATACCTGCA	1
GCAGGTATGAGGATGGACCTG	CAGGTCCATCCTCATACCTGC	1
CAGGTATGAGGATGGACCTGA	TCAGGTCCATCCTCATACCTG	1
AGGTATGAGGATGGACCTGAT	ATCAGGTCCATCCTCATACCT	1
GGTATGAGGATGGACCTGATG	CATCAGGTCCATCCTCATACC	1
GTATGAGGATGGACCTGATGG	CCATCAGGTCCATCCTCATAC	1
TATGAGGATGGACCTGATGGG	CCCATCAGGTCCATCCTCATA	1
ATGAGGATGGACCTGATGGGT	ACCCATCAGGTCCATCCTCAT	1
TGAGGATGGACCTGATGGGTT	AACCCATCAGGTCCATCCTCA	1
GAGGATGGACCTGATGGGTTC	GAACCCATCAGGTCCATCCTC	1
AGGATGGACCTGATGGGTTCC	GGAACCCATCAGGTCCATCCT	1
GGATGGACCTGATGGGTTCCT	AGGAACCCATCAGGTCCATCC	1
GATGGACCTGATGGGTTCCTG	CAGGAACCCATCAGGTCCATC	1
ATGGACCTGATGGGTTCCTGG	CCAGGAACCCATCAGGTCCAT	1
TGGACCTGATGGGTTCCTGGA	TCCAGGAACCCATCAGGTCCA	1
GGACCTGATGGGTTCCTGGAC	GTCCAGGAACCCATCAGGTCC	1
GACCTGATGGGTTCCTGGACC	GGTCCAGGAACCCATCAGGTC	1
ACCTGATGGGTTCCTGGACCC	GGGTCCAGGAACCCATCAGGT	1
CCTGATGGGTTCCTGGACCCT	AGGGTCCAGGAACCCATCAGG	1
CTGATGGGTTCCTGGACCCTC	GAGGGTCCAGGAACCCATCAG	1
TGATGGGTTCCTGGACCCTCC	GGAGGGTCCAGGAACCCATCA	1
GATGGGTTCCTGGACCCTCCC	GGGAGGGTCCAGGAACCCATC	1
ATGGGTTCCTGGACCCTCCCC	GGGGAGGGTCCAGGAACCCAT	1
TGGGTTCCTGGACCCTCCCCT	AGGGGAGGGTCCAGGAACCCA	1
GGGTTCCTGGACCCTCCCCTC	GAGGGGAGGGTCCAGGAACCC	1
GGTTCCTGGACCCTCCCCTCT	AGAGGGGAGGGTCCAGGAACC	1
GTTCCTGGACCCTCCCCTCTC	GAGAGGGGAGGGTCCAGGAAC	1
TTCCTGGACCCTCCCCTCTCA	TGAGAGGGGAGGGTCCAGGAA	1
TCCTGGACCCTCCCCTCTCAC	GTGAGAGGGGAGGGTCCAGGA	1
CCTGGACCCTCCCCTCTCACC	GGTGAGAGGGGAGGGTCCAGG	1
CTGGACCCTCCCCTCTCACCC	GGGTGAGAGGGGAGGGTCCAG	1
TGGACCCTCCCCTCTCACCCT	AGGGTGAGAGGGGAGGGTCCA	1
GGACCCTCCCCTCTCACCCTG	CAGGGTGAGAGGGGAGGGTCC	1
GACCCTCCCCTCTCACCCTGG	CCAGGGTGAGAGGGGAGGGTC	1
ACCCTCCCCTCTCACCCTGGT	ACCAGGGTGAGAGGGGAGGGT	1
CCCTCCCCTCTCACCCTGGTC	GACCAGGGTGAGAGGGGAGGG	1
CCTCCCCTCTCACCCTGGTCC	GGACCAGGGTGAGAGGGGAGG	1
CTCCCCTCTCACCCTGGTCCC	GGGACCAGGGTGAGAGGGGAG	1
TCCCCTCTCACCCTGGTCCCT	AGGGACCAGGGTGAGAGGGGA	1
CCCCTCTCACCCTGGTCCCTC	GAGGGACCAGGGTGAGAGGGG	1
CCCTCTCACCCTGGTCCCTCA	TGAGGGACCAGGGTGAGAGGG	1
CCTCTCACCCTGGTCCCTCAG	CTGAGGGACCAGGGTGAGAGG	1
CTCTCACCCTGGTCCCTCAGT	ACTGAGGGACCAGGGTGAGAG	1
TCTCACCCTGGTCCCTCAGTC	GACTGAGGGACCAGGGTGAGA	1
CTCACCCTGGTCCCTCAGTCT	AGACTGAGGGACCAGGGTGAG	1
TCACCCTGGTCCCTCAGTCTC	GAGACTGAGGGACCAGGGTGA	1
CACCCTGGTCCCTCAGTCTCA	TGAGACTGAGGGACCAGGGTG	1
ACCCTGGTCCCTCAGTCTCAT	ATGAGACTGAGGGACCAGGGT	1
CCCTGGTCCCTCAGTCTCATT	AATGAGACTGAGGGACCAGGG	1
CCTGGTCCCTCAGTCTCATTC	GAATGAGACTGAGGGACCAGG	1
CTGGTCCCTCAGTCTCATTCC	GGAATGAGACTGAGGGACCAG	1
TGGTCCCTCAGTCTCATTCCC	GGGAATGAGACTGAGGGACCA	1
GGTCCCTCAGTCTCATTCCCC	GGGGAATGAGACTGAGGGACC	1
GTCCCTCAGTCTCATTCCCCC	GGGGGAATGAGACTGAGGGAC	1
TCCCTCAGTCTCATTCCCCCA	TGGGGGAATGAGACTGAGGGA	1
CCCTCAGTCTCATTCCCCCAC	GTGGGGGAATGAGACTGAGGG	1
CCTCAGTCTCATTCCCCCACT	AGTGGGGGAATGAGACTGAGG	1
CTCAGTCTCATTCCCCCACTC	GAGTGGGGGAATGAGACTGAG	1
TCAGTCTCATTCCCCCACTCC	GGAGTGGGGGAATGAGACTGA	1
CAGTCTCATTCCCCCACTCCT	AGGAGTGGGGGAATGAGACTG	1
AGTCTCATTCCCCCACTCCTG	CAGGAGTGGGGGAATGAGACT	1
GTCTCATTCCCCCACTCCTGC	GCAGGAGTGGGGGAATGAGAC	1
TCTCATTCCCCCACTCCTGCC	GGCAGGAGTGGGGGAATGAGA	1
CTCATTCCCCCACTCCTGCCA	TGGCAGGAGTGGGGGAATGAG	1
TCATTCCCCCACTCCTGCCAC	GTGGCAGGAGTGGGGGAATGA	1
CATTCCCCCACTCCTGCCACC	GGTGGCAGGAGTGGGGGAATG	1
ATTCCCCCACTCCTGCCACCT	AGGTGGCAGGAGTGGGGGAAT	1
TTCCCCCACTCCTGCCACCTC	GAGGTGGCAGGAGTGGGGGAA	1
TCCCCCACTCCTGCCACCTCC	GGAGGTGGCAGGAGTGGGGGA	1
CCCCCACTCCTGCCACCTCCT	AGGAGGTGGCAGGAGTGGGGG	1
CCCCACTCCTGCCACCTCCTG	CAGGAGGTGGCAGGAGTGGGG	1
CCCACTCCTGCCACCTCCTGT	ACAGGAGGTGGCAGGAGTGGG	1
CCACTCCTGCCACCTCCTGTC	GACAGGAGGTGGCAGGAGTGG	1
CACTCCTGCCACCTCCTGTCT	AGACAGGAGGTGGCAGGAGTG	1
ACTCCTGCCACCTCCTGTCTG	CAGACAGGAGGTGGCAGGAGT	1
CTCCTGCCACCTCCTGTCTGG	CCAGACAGGAGGTGGCAGGAG	1
TCCTGCCACCTCCTGTCTGGC	GCCAGACAGGAGGTGGCAGGA	1
CCTGCCACCTCCTGTCTGGCC	GGCCAGACAGGAGGTGGCAGG	1
CTGCCACCTCCTGTCTGGCCA	TGGCCAGACAGGAGGTGGCAG	1
TGCCACCTCCTGTCTGGCCAT	ATGGCCAGACAGGAGGTGGCA	1
GCCACCTCCTGTCTGGCCATC	GATGGCCAGACAGGAGGTGGC	1
CCACCTCCTGTCTGGCCATCA	TGATGGCCAGACAGGAGGTGG	1
CACCTCCTGTCTGGCCATCAG	CTGATGGCCAGACAGGAGGTG	1
ACCTCCTGTCTGGCCATCAGG	CCTGATGGCCAGACAGGAGGT	1
CCTCCTGTCTGGCCATCAGGA	TCCTGATGGCCAGACAGGAGG	1
CTCCTGTCTGGCCATCAGGAA	TTCCTGATGGCCAGACAGGAG	1
TCCTGTCTGGCCATCAGGAAG	CTTCCTGATGGCCAGACAGGA	1
CCTGTCTGGCCATCAGGAAGG	CCTTCCTGATGGCCAGACAGG	1
CTGTCTGGCCATCAGGAAGGC	GCCTTCCTGATGGCCAGACAG	1
TGTCTGGCCATCAGGAAGGCC	GGCCTTCCTGATGGCCAGACA	1
GTCTGGCCATCAGGAAGGCCA	TGGCCTTCCTGATGGCCAGAC	1
TCTGGCCATCAGGAAGGCCAG	CTGGCCTTCCTGATGGCCAGA	1
CTGGCCATCAGGAAGGCCAGC	GCTGGCCTTCCTGATGGCCAG	1
TGGCCATCAGGAAGGCCAGCC	GGCTGGCCTTCCTGATGGCCA	1
GGCCATCAGGAAGGCCAGCCT	AGGCTGGCCTTCCTGATGGCC	1
GCCATCAGGAAGGCCAGCCTG	CAGGCTGGCCTTCCTGATGGC	1
CCATCAGGAAGGCCAGCCTGC	GCAGGCTGGCCTTCCTGATGG	1
CATCAGGAAGGCCAGCCTGCT	AGCAGGCTGGCCTTCCTGATG	1
ATCAGGAAGGCCAGCCTGCTC	GAGCAGGCTGGCCTTCCTGAT	1
TCAGGAAGGCCAGCCTGCTCC	GGAGCAGGCTGGCCTTCCTGA	1
CAGGAAGGCCAGCCTGCTCCC	GGGAGCAGGCTGGCCTTCCTG	1
AGGAAGGCCAGCCTGCTCCCC	GGGGAGCAGGCTGGCCTTCCT	1
GGAAGGCCAGCCTGCTCCCCA	TGGGGAGCAGGCTGGCCTTCC	1
GAAGGCCAGCCTGCTCCCCAC	GTGGGGAGCAGGCTGGCCTTC	1
AAGGCCAGCCTGCTCCCCACC	GGTGGGGAGCAGGCTGGCCTT	1
AGGCCAGCCTGCTCCCCACCT	AGGTGGGGAGCAGGCTGGCCT	1
GGCCAGCCTGCTCCCCACCTG	CAGGTGGGGAGCAGGCTGGCC	1
GCCAGCCTGCTCCCCACCTGA	TCAGGTGGGGAGCAGGCTGGC	1
CCAGCCTGCTCCCCACCTGAT	ATCAGGTGGGGAGCAGGCTGG	1
CAGCCTGCTCCCCACCTGATC	GATCAGGTGGGGAGCAGGCTG	1
AGCCTGCTCCCCACCTGATCC	GGATCAGGTGGGGAGCAGGCT	1
GCCTGCTCCCCACCTGATCCT	AGGATCAGGTGGGGAGCAGGC	1
CCTGCTCCCCACCTGATCCTC	GAGGATCAGGTGGGGAGCAGG	1
CTGCTCCCCACCTGATCCTCC	GGAGGATCAGGTGGGGAGCAG	1
TGCTCCCCACCTGATCCTCCC	GGGAGGATCAGGTGGGGAGCA	1
GCTCCCCACCTGATCCTCCCA	TGGGAGGATCAGGTGGGGAGC	1
CTCCCCACCTGATCCTCCCAA	TTGGGAGGATCAGGTGGGGAG	1
TCCCCACCTGATCCTCCCAAA	TTTGGGAGGATCAGGTGGGGA	1
CCCCACCTGATCCTCCCAAAC	GTTTGGGAGGATCAGGTGGGG	1
CCCACCTGATCCTCCCAAACC	GGTTTGGGAGGATCAGGTGGG	1
CCACCTGATCCTCCCAAACCC	GGGTTTGGGAGGATCAGGTGG	1
CACCTGATCCTCCCAAACCCA	TGGGTTTGGGAGGATCAGGTG	1
ACCTGATCCTCCCAAACCCAG	CTGGGTTTGGGAGGATCAGGT	1
CCTGATCCTCCCAAACCCAGA	TCTGGGTTTGGGAGGATCAGG	1
CTGATCCTCCCAAACCCAGAG	CTCTGGGTTTGGGAGGATCAG	1
TGATCCTCCCAAACCCAGAGC	GCTCTGGGTTTGGGAGGATCA	1
GATCCTCCCAAACCCAGAGCC	GGCTCTGGGTTTGGGAGGATC	1
ATCCTCCCAAACCCAGAGCCA	TGGCTCTGGGTTTGGGAGGAT	1
TCCTCCCAAACCCAGAGCCAC	GTGGCTCTGGGTTTGGGAGGA	1
CCTCCCAAACCCAGAGCCACC	GGTGGCTCTGGGTTTGGGAGG	1
CTCCCAAACCCAGAGCCACCT	AGGTGGCTCTGGGTTTGGGAG	1
TCCCAAACCCAGAGCCACCTG	CAGGTGGCTCTGGGTTTGGGA	1
CCCAAACCCAGAGCCACCTGA	TCAGGTGGCTCTGGGTTTGGG	1
CCAAACCCAGAGCCACCTGAT	ATCAGGTGGCTCTGGGTTTGG	1
CAAACCCAGAGCCACCTGATG	CATCAGGTGGCTCTGGGTTTG	1
AAACCCAGAGCCACCTGATGC	GCATCAGGTGGCTCTGGGTTT	1
AACCCAGAGCCACCTGATGCC	GGCATCAGGTGGCTCTGGGTT	1
ACCCAGAGCCACCTGATGCCT	AGGCATCAGGTGGCTCTGGGT	1
CCCAGAGCCACCTGATGCCTG	CAGGCATCAGGTGGCTCTGGG	1
CCAGAGCCACCTGATGCCTGC	GCAGGCATCAGGTGGCTCTGG	1
CAGAGCCACCTGATGCCTGCC	GGCAGGCATCAGGTGGCTCTG	1
AGAGCCACCTGATGCCTGCCC	GGGCAGGCATCAGGTGGCTCT	1
GAGCCACCTGATGCCTGCCCC	GGGGCAGGCATCAGGTGGCTC	1
AGCCACCTGATGCCTGCCCCT	AGGGGCAGGCATCAGGTGGCT	1
GCCACCTGATGCCTGCCCCTC	GAGGGGCAGGCATCAGGTGGC	1
CCACCTGATGCCTGCCCCTCT	AGAGGGGCAGGCATCAGGTGG	1
CACCTGATGCCTGCCCCTCTG	CAGAGGGGCAGGCATCAGGTG	1
ACCTGATGCCTGCCCCTCTGC	GCAGAGGGGCAGGCATCAGGT	1
CCTGATGCCTGCCCCTCTGCT	AGCAGAGGGGCAGGCATCAGG	1
CTGATGCCTGCCCCTCTGCTC	GAGCAGAGGGGCAGGCATCAG	1
TGATGCCTGCCCCTCTGCTCC	GGAGCAGAGGGGCAGGCATCA	1
GATGCCTGCCCCTCTGCTCCA	TGGAGCAGAGGGGCAGGCATC	1
ATGCCTGCCCCTCTGCTCCAC	GTGGAGCAGAGGGGCAGGCAT	1
TGCCTGCCCCTCTGCTCCACA	TGTGGAGCAGAGGGGCAGGCA	1
GCCTGCCCCTCTGCTCCACAG	CTGTGGAGCAGAGGGGCAGGC	1
CCTGCCCCTCTGCTCCACAGC	GCTGTGGAGCAGAGGGGCAGG	1
CTGCCCCTCTGCTCCACAGCC	GGCTGTGGAGCAGAGGGGCAG	1
TGCCCCTCTGCTCCACAGCCT	AGGCTGTGGAGCAGAGGGGCA	1
GCCCCTCTGCTCCACAGCCTT	AAGGCTGTGGAGCAGAGGGGC	1
CCCCTCTGCTCCACAGCCTTT	AAAGGCTGTGGAGCAGAGGGG	1
CCCTCTGCTCCACAGCCTTTG	CAAAGGCTGTGGAGCAGAGGG	1
CCTCTGCTCCACAGCCTTTGT	ACAAAGGCTGTGGAGCAGAGG	1
CTCTGCTCCACAGCCTTTGTG	CACAAAGGCTGTGGAGCAGAG	1
TCTGCTCCACAGCCTTTGTGT	ACACAAAGGCTGTGGAGCAGA	1
CTGCTCCACAGCCTTTGTGTC	GACACAAAGGCTGTGGAGCAG	1
TGCTCCACAGCCTTTGTGTCC	GGACACAAAGGCTGTGGAGCA	1
GCTCCACAGCCTTTGTGTCCA	TGGACACAAAGGCTGTGGAGC	1
CTCCACAGCCTTTGTGTCCAA	TTGGACACAAAGGCTGTGGAG	1
TCCACAGCCTTTGTGTCCAAG	CTTGGACACAAAGGCTGTGGA	1
CCACAGCCTTTGTGTCCAAGC	GCTTGGACACAAAGGCTGTGG	1
CACAGCCTTTGTGTCCAAGCA	TGCTTGGACACAAAGGCTGTG	1
ACAGCCTTTGTGTCCAAGCAG	CTGCTTGGACACAAAGGCTGT	1
CAGCCTTTGTGTCCAAGCAGG	CCTGCTTGGACACAAAGGCTG	1
AGCCTTTGTGTCCAAGCAGGA	TCCTGCTTGGACACAAAGGCT	1
GCCTTTGTGTCCAAGCAGGAG	CTCCTGCTTGGACACAAAGGC	1
CCTTTGTGTCCAAGCAGGAGG	CCTCCTGCTTGGACACAAAGG	1
CTTTGTGTCCAAGCAGGAGGG	CCCTCCTGCTTGGACACAAAG	1
TTTGTGTCCAAGCAGGAGGGC	GCCCTCCTGCTTGGACACAAA	1
TTGTGTCCAAGCAGGAGGGCA	TGCCCTCCTGCTTGGACACAA	1
TGTGTCCAAGCAGGAGGGCAG	CTGCCCTCCTGCTTGGACACA	1
GTGTCCAAGCAGGAGGGCAGC	GCTGCCCTCCTGCTTGGACAC	1
TGTCCAAGCAGGAGGGCAGCG	CGCTGCCCTCCTGCTTGGACA	1
GTCCAAGCAGGAGGGCAGCGA	TCGCTGCCCTCCTGCTTGGAC	1
TCCAAGCAGGAGGGCAGCGAG	CTCGCTGCCCTCCTGCTTGGA	1
CCAAGCAGGAGGGCAGCGAGG	CCTCGCTGCCCTCCTGCTTGG	1
CAAGCAGGAGGGCAGCGAGGT	ACCTCGCTGCCCTCCTGCTTG	1
AAGCAGGAGGGCAGCGAGGTA	TACCTCGCTGCCCTCCTGCTT	1
AGCAGGAGGGCAGCGAGGTAG	CTACCTCGCTGCCCTCCTGCT	1
GCAGGAGGGCAGCGAGGTAGT	ACTACCTCGCTGCCCTCCTGC	1
CAGGAGGGCAGCGAGGTAGTG	CACTACCTCGCTGCCCTCCTG	1
AGGAGGGCAGCGAGGTAGTGA	TCACTACCTCGCTGCCCTCCT	1
GGAGGGCAGCGAGGTAGTGAA	TTCACTACCTCGCTGCCCTCC	1
GAGGGCAGCGAGGTAGTGAAG	CTTCACTACCTCGCTGCCCTC	1
AGGGCAGCGAGGTAGTGAAGA	TCTTCACTACCTCGCTGCCCT	1
GGGCAGCGAGGTAGTGAAGAG	CTCTTCACTACCTCGCTGCCC	1
GGCAGCGAGGTAGTGAAGAGA	TCTCTTCACTACCTCGCTGCC	1
GCAGCGAGGTAGTGAAGAGAC	GTCTCTTCACTACCTCGCTGC	1
CAGCGAGGTAGTGAAGAGACC	GGTCTCTTCACTACCTCGCTG	1
AGCGAGGTAGTGAAGAGACCC	GGGTCTCTTCACTACCTCGCT	1
GCGAGGTAGTGAAGAGACCCA	TGGGTCTCTTCACTACCTCGC	1
CGAGGTAGTGAAGAGACCCAG	CTGGGTCTCTTCACTACCTCG	1
GAGGTAGTGAAGAGACCCAGG	CCTGGGTCTCTTCACTACCTC	1
AGGTAGTGAAGAGACCCAGGC	GCCTGGGTCTCTTCACTACCT	1
GGTAGTGAAGAGACCCAGGCG	CGCCTGGGTCTCTTCACTACC	1
GTAGTGAAGAGACCCAGGCGC	GCGCCTGGGTCTCTTCACTAC	1
TAGTGAAGAGACCCAGGCGCT	AGCGCCTGGGTCTCTTCACTA	1
AGTGAAGAGACCCAGGCGCTA	TAGCGCCTGGGTCTCTTCACT	1
GTGAAGAGACCCAGGCGCTAC	GTAGCGCCTGGGTCTCTTCAC	1
TGAAGAGACCCAGGCGCTACC	GGTAGCGCCTGGGTCTCTTCA	1
GAAGAGACCCAGGCGCTACCT	AGGTAGCGCCTGGGTCTCTTC	1
AAGAGACCCAGGCGCTACCTG	CAGGTAGCGCCTGGGTCTCTT	1
AGAGACCCAGGCGCTACCTGT	ACAGGTAGCGCCTGGGTCTCT	1
GAGACCCAGGCGCTACCTGTA	TACAGGTAGCGCCTGGGTCTC	1
AGACCCAGGCGCTACCTGTAT	ATACAGGTAGCGCCTGGGTCT	1
GACCCAGGCGCTACCTGTATC	GATACAGGTAGCGCCTGGGTC	1
ACCCAGGCGCTACCTGTATCA	TGATACAGGTAGCGCCTGGGT	1
CCCAGGCGCTACCTGTATCAA	TTGATACAGGTAGCGCCTGGG	1
CCAGGCGCTACCTGTATCAAT	ATTGATACAGGTAGCGCCTGG	1
CAGGCGCTACCTGTATCAATG	CATTGATACAGGTAGCGCCTG	1
AGGCGCTACCTGTATCAATGG	CCATTGATACAGGTAGCGCCT	1
GGCGCTACCTGTATCAATGGC	GCCATTGATACAGGTAGCGCC	1
GCGCTACCTGTATCAATGGCT	AGCCATTGATACAGGTAGCGC	1
CGCTACCTGTATCAATGGCTG	CAGCCATTGATACAGGTAGCG	1
GCTACCTGTATCAATGGCTGG	CCAGCCATTGATACAGGTAGC	1
CTACCTGTATCAATGGCTGGG	CCCAGCCATTGATACAGGTAG	1
TACCTGTATCAATGGCTGGGG	CCCCAGCCATTGATACAGGTA	1
ACCTGTATCAATGGCTGGGGT	ACCCCAGCCATTGATACAGGT	1
CCTGTATCAATGGCTGGGGTG	CACCCCAGCCATTGATACAGG	1
CTGTATCAATGGCTGGGGTGA	TCACCCCAGCCATTGATACAG	1
TGTATCAATGGCTGGGGTGAG	CTCACCCCAGCCATTGATACA	1
GTATCAATGGCTGGGGTGAGA	TCTCACCCCAGCCATTGATAC	1
TATCAATGGCTGGGGTGAGAG	CTCTCACCCCAGCCATTGATA	1
ATCAATGGCTGGGGTGAGAGA	TCTCTCACCCCAGCCATTGAT	1
TCAATGGCTGGGGTGAGAGAA	TTCTCTCACCCCAGCCATTGA	1
CAATGGCTGGGGTGAGAGAAA	TTTCTCTCACCCCAGCCATTG	1
AATGGCTGGGGTGAGAGAAAA	TTTTCTCTCACCCCAGCCATT	1
ATGGCTGGGGTGAGAGAAAAG	CTTTTCTCTCACCCCAGCCAT	1
TGGCTGGGGTGAGAGAAAAGG	CCTTTTCTCTCACCCCAGCCA	1
GGCTGGGGTGAGAGAAAAGGC	GCCTTTTCTCTCACCCCAGCC	1
GCTGGGGTGAGAGAAAAGGCA	TGCCTTTTCTCTCACCCCAGC	1
CTGGGGTGAGAGAAAAGGCAG	CTGCCTTTTCTCTCACCCCAG	1
TGGGGTGAGAGAAAAGGCAGA	TCTGCCTTTTCTCTCACCCCA	1
GGGGTGAGAGAAAAGGCAGAG	CTCTGCCTTTTCTCTCACCCC	1
GGGTGAGAGAAAAGGCAGAGC	GCTCTGCCTTTTCTCTCACCC	1
GGTGAGAGAAAAGGCAGAGCT	AGCTCTGCCTTTTCTCTCACC	1
GTGAGAGAAAAGGCAGAGCTG	CAGCTCTGCCTTTTCTCTCAC	1
TGAGAGAAAAGGCAGAGCTGG	CCAGCTCTGCCTTTTCTCTCA	1
GAGAGAAAAGGCAGAGCTGGG	CCCAGCTCTGCCTTTTCTCTC	1
AGAGAAAAGGCAGAGCTGGGC	GCCCAGCTCTGCCTTTTCTCT	1
GAGAAAAGGCAGAGCTGGGCC	GGCCCAGCTCTGCCTTTTCTC	1
AGAAAAGGCAGAGCTGGGCCA	TGGCCCAGCTCTGCCTTTTCT	1
GAAAAGGCAGAGCTGGGCCAA	TTGGCCCAGCTCTGCCTTTTC	1
AAAAGGCAGAGCTGGGCCAAG	CTTGGCCCAGCTCTGCCTTTT	1
AAAGGCAGAGCTGGGCCAAGG	CCTTGGCCCAGCTCTGCCTTT	1
AAGGCAGAGCTGGGCCAAGGC	GCCTTGGCCCAGCTCTGCCTT	1
AGGCAGAGCTGGGCCAAGGCC	GGCCTTGGCCCAGCTCTGCCT	1
GGCAGAGCTGGGCCAAGGCCC	GGGCCTTGGCCCAGCTCTGCC	1
GCAGAGCTGGGCCAAGGCCCT	AGGGCCTTGGCCCAGCTCTGC	1
CAGAGCTGGGCCAAGGCCCTG	CAGGGCCTTGGCCCAGCTCTG	1
AGAGCTGGGCCAAGGCCCTGC	GCAGGGCCTTGGCCCAGCTCT	1
GAGCTGGGCCAAGGCCCTGCC	GGCAGGGCCTTGGCCCAGCTC	1
AGCTGGGCCAAGGCCCTGCCT	AGGCAGGGCCTTGGCCCAGCT	1
GCTGGGCCAAGGCCCTGCCTC	GAGGCAGGGCCTTGGCCCAGC	1
CTGGGCCAAGGCCCTGCCTCT	AGAGGCAGGGCCTTGGCCCAG	1
TGGGCCAAGGCCCTGCCTCTC	GAGAGGCAGGGCCTTGGCCCA	1
GGGCCAAGGCCCTGCCTCTCC	GGAGAGGCAGGGCCTTGGCCC	1
GGCCAAGGCCCTGCCTCTCCG	CGGAGAGGCAGGGCCTTGGCC	1
GCCAAGGCCCTGCCTCTCCGG	CCGGAGAGGCAGGGCCTTGGC	1
CCAAGGCCCTGCCTCTCCGGG	CCCGGAGAGGCAGGGCCTTGG	1
CAAGGCCCTGCCTCTCCGGGA	TCCCGGAGAGGCAGGGCCTTG	1
AAGGCCCTGCCTCTCCGGGAT	ATCCCGGAGAGGCAGGGCCTT	1
AGGCCCTGCCTCTCCGGGATG	CATCCCGGAGAGGCAGGGCCT	1
GGCCCTGCCTCTCCGGGATGG	CCATCCCGGAGAGGCAGGGCC	1
GCCCTGCCTCTCCGGGATGGT	ACCATCCCGGAGAGGCAGGGC	1
CCCTGCCTCTCCGGGATGGTC	GACCATCCCGGAGAGGCAGGG	1
CCTGCCTCTCCGGGATGGTCT	AGACCATCCCGGAGAGGCAGG	1
CTGCCTCTCCGGGATGGTCTG	CAGACCATCCCGGAGAGGCAG	1
TGCCTCTCCGGGATGGTCTGT	ACAGACCATCCCGGAGAGGCA	1
GCCTCTCCGGGATGGTCTGTG	CACAGACCATCCCGGAGAGGC	1
CCTCTCCGGGATGGTCTGTGG	CCACAGACCATCCCGGAGAGG	1
CTCTCCGGGATGGTCTGTGGG	CCCACAGACCATCCCGGAGAG	1
TCTCCGGGATGGTCTGTGGGG	CCCCACAGACCATCCCGGAGA	1
CTCCGGGATGGTCTGTGGGGG	CCCCCACAGACCATCCCGGAG	1
TCCGGGATGGTCTGTGGGGGA	TCCCCCACAGACCATCCCGGA	1
CCGGGATGGTCTGTGGGGGAG	CTCCCCCACAGACCATCCCGG	1
CGGGATGGTCTGTGGGGGAGC	GCTCCCCCACAGACCATCCCG	1
GGGATGGTCTGTGGGGGAGCT	AGCTCCCCCACAGACCATCCC	1
GGATGGTCTGTGGGGGAGCTG	CAGCTCCCCCACAGACCATCC	1
GATGGTCTGTGGGGGAGCTGC	GCAGCTCCCCCACAGACCATC	1
ATGGTCTGTGGGGGAGCTGCA	TGCAGCTCCCCCACAGACCAT	1
TGGTCTGTGGGGGAGCTGCAG	CTGCAGCTCCCCCACAGACCA	1
GGTCTGTGGGGGAGCTGCAGC	GCTGCAGCTCCCCCACAGACC	1
GTCTGTGGGGGAGCTGCAGCA	TGCTGCAGCTCCCCCACAGAC	1
TCTGTGGGGGAGCTGCAGCAG	CTGCTGCAGCTCCCCCACAGA	1
CTGTGGGGGAGCTGCAGCAGG	CCTGCTGCAGCTCCCCCACAG	1
TGTGGGGGAGCTGCAGCAGGG	CCCTGCTGCAGCTCCCCCACA	1
GTGGGGGAGCTGCAGCAGGGA	TCCCTGCTGCAGCTCCCCCAC	1
TGGGGGAGCTGCAGCAGGGAG	CTCCCTGCTGCAGCTCCCCCA	1
GGGGGAGCTGCAGCAGGGAGT	ACTCCCTGCTGCAGCTCCCCC	1
GGGGAGCTGCAGCAGGGAGTG	CACTCCCTGCTGCAGCTCCCC	1
GGGAGCTGCAGCAGGGAGTGG	CCACTCCCTGCTGCAGCTCCC	1
GGAGCTGCAGCAGGGAGTGGC	GCCACTCCCTGCTGCAGCTCC	1
GAGCTGCAGCAGGGAGTGGCC	GGCCACTCCCTGCTGCAGCTC	1
AGCTGCAGCAGGGAGTGGCCT	AGGCCACTCCCTGCTGCAGCT	1
GCTGCAGCAGGGAGTGGCCTC	GAGGCCACTCCCTGCTGCAGC	1
CTGCAGCAGGGAGTGGCCTCT	AGAGGCCACTCCCTGCTGCAG	1
TGCAGCAGGGAGTGGCCTCTC	GAGAGGCCACTCCCTGCTGCA	1
GCAGCAGGGAGTGGCCTCTCT	AGAGAGGCCACTCCCTGCTGC	1
CAGCAGGGAGTGGCCTCTCTG	CAGAGAGGCCACTCCCTGCTG	1
AGCAGGGAGTGGCCTCTCTGG	CCAGAGAGGCCACTCCCTGCT	1
GCAGGGAGTGGCCTCTCTGGG	CCCAGAGAGGCCACTCCCTGC	1
CAGGGAGTGGCCTCTCTGGGT	ACCCAGAGAGGCCACTCCCTG	1
AGGGAGTGGCCTCTCTGGGTT	AACCCAGAGAGGCCACTCCCT	1
GGGAGTGGCCTCTCTGGGTTG	CAACCCAGAGAGGCCACTCCC	1
GGAGTGGCCTCTCTGGGTTGT	ACAACCCAGAGAGGCCACTCC	1
GAGTGGCCTCTCTGGGTTGTG	CACAACCCAGAGAGGCCACTC	1
AGTGGCCTCTCTGGGTTGTGG	CCACAACCCAGAGAGGCCACT	1
GTGGCCTCTCTGGGTTGTGGT	ACCACAACCCAGAGAGGCCAC	1
TGGCCTCTCTGGGTTGTGGTG	CACCACAACCCAGAGAGGCCA	1
GGCCTCTCTGGGTTGTGGTGG	CCACCACAACCCAGAGAGGCC	1
GCCTCTCTGGGTTGTGGTGGG	CCCACCACAACCCAGAGAGGC	1
CCTCTCTGGGTTGTGGTGGGG	CCCCACCACAACCCAGAGAGG	1
CTCTCTGGGTTGTGGTGGGGG	CCCCCACCACAACCCAGAGAG	1
TCTCTGGGTTGTGGTGGGGGT	ACCCCCACCACAACCCAGAGA	1
CTCTGGGTTGTGGTGGGGGTA	TACCCCCACCACAACCCAGAG	1
TCTGGGTTGTGGTGGGGGTAC	GTACCCCCACCACAACCCAGA	1
CTGGGTTGTGGTGGGGGTACA	TGTACCCCCACCACAACCCAG	1
TGGGTTGTGGTGGGGGTACAG	CTGTACCCCCACCACAACCCA	1
GGGTTGTGGTGGGGGTACAGG	CCTGTACCCCCACCACAACCC	1
GGTTGTGGTGGGGGTACAGGC	GCCTGTACCCCCACCACAACC	1
GTTGTGGTGGGGGTACAGGCA	TGCCTGTACCCCCACCACAAC	1
TTGTGGTGGGGGTACAGGCAG	CTGCCTGTACCCCCACCACAA	1
TGTGGTGGGGGTACAGGCAGC	GCTGCCTGTACCCCCACCACA	1
GTGGTGGGGGTACAGGCAGCC	GGCTGCCTGTACCCCCACCAC	1
TGGTGGGGGTACAGGCAGCCT	AGGCTGCCTGTACCCCCACCA	1
GGTGGGGGTACAGGCAGCCTG	CAGGCTGCCTGTACCCCCACC	1
GTGGGGGTACAGGCAGCCTGC	GCAGGCTGCCTGTACCCCCAC	1
TGGGGGTACAGGCAGCCTGCC	GGCAGGCTGCCTGTACCCCCA	1
GGGGGTACAGGCAGCCTGCCC	GGGCAGGCTGCCTGTACCCCC	1
GGGGTACAGGCAGCCTGCCCT	AGGGCAGGCTGCCTGTACCCC	1
GGGTACAGGCAGCCTGCCCTG	CAGGGCAGGCTGCCTGTACCC	1
GGTACAGGCAGCCTGCCCTGG	CCAGGGCAGGCTGCCTGTACC	1
GTACAGGCAGCCTGCCCTGGT	ACCAGGGCAGGCTGCCTGTAC	1
TACAGGCAGCCTGCCCTGGTG	CACCAGGGCAGGCTGCCTGTA	1
ACAGGCAGCCTGCCCTGGTGG	CCACCAGGGCAGGCTGCCTGT	1
CAGGCAGCCTGCCCTGGTGGG	CCCACCAGGGCAGGCTGCCTG	1
AGGCAGCCTGCCCTGGTGGGC	GCCCACCAGGGCAGGCTGCCT	1
GGCAGCCTGCCCTGGTGGGCA	TGCCCACCAGGGCAGGCTGCC	1
GCAGCCTGCCCTGGTGGGCAC	GTGCCCACCAGGGCAGGCTGC	1
CAGCCTGCCCTGGTGGGCACC	GGTGCCCACCAGGGCAGGCTG	1
AGCCTGCCCTGGTGGGCACCC	GGGTGCCCACCAGGGCAGGCT	1
GCCTGCCCTGGTGGGCACCCT	AGGGTGCCCACCAGGGCAGGC	1
CCTGCCCTGGTGGGCACCCTG	CAGGGTGCCCACCAGGGCAGG	1
CTGCCCTGGTGGGCACCCTGG	CCAGGGTGCCCACCAGGGCAG	1
TGCCCTGGTGGGCACCCTGGA	TCCAGGGTGCCCACCAGGGCA	1
GCCCTGGTGGGCACCCTGGAG	CTCCAGGGTGCCCACCAGGGC	1
CCCTGGTGGGCACCCTGGAGC	GCTCCAGGGTGCCCACCAGGG	1
CCTGGTGGGCACCCTGGAGCC	GGCTCCAGGGTGCCCACCAGG	1
CTGGTGGGCACCCTGGAGCCC	GGGCTCCAGGGTGCCCACCAG	1
TGGTGGGCACCCTGGAGCCCC	GGGGCTCCAGGGTGCCCACCA	1
GGTGGGCACCCTGGAGCCCCA	TGGGGCTCCAGGGTGCCCACC	1
GTGGGCACCCTGGAGCCCCAT	ATGGGGCTCCAGGGTGCCCAC	1
TGGGCACCCTGGAGCCCCATG	CATGGGGCTCCAGGGTGCCCA	1
GGGCACCCTGGAGCCCCATGT	ACATGGGGCTCCAGGGTGCCC	1
GGCACCCTGGAGCCCCATGTG	CACATGGGGCTCCAGGGTGCC	1
GCACCCTGGAGCCCCATGTGT	ACACATGGGGCTCCAGGGTGC	1
CACCCTGGAGCCCCATGTGTA	TACACATGGGGCTCCAGGGTG	1
ACCCTGGAGCCCCATGTGTAG	CTACACATGGGGCTCCAGGGT	1
CCCTGGAGCCCCATGTGTAGG	CCTACACATGGGGCTCCAGGG	1
CCTGGAGCCCCATGTGTAGGG	CCCTACACATGGGGCTCCAGG	1
CTGGAGCCCCATGTGTAGGGA	TCCCTACACATGGGGCTCCAG	1
TGGAGCCCCATGTGTAGGGAG	CTCCCTACACATGGGGCTCCA	1
GGAGCCCCATGTGTAGGGAGA	TCTCCCTACACATGGGGCTCC	1
GAGCCCCATGTGTAGGGAGAG	CTCTCCCTACACATGGGGCTC	1
AGCCCCATGTGTAGGGAGAGG	CCTCTCCCTACACATGGGGCT	1
GCCCCATGTGTAGGGAGAGGA	TCCTCTCCCTACACATGGGGC	1
CCCCATGTGTAGGGAGAGGAG	CTCCTCTCCCTACACATGGGG	1
CCCATGTGTAGGGAGAGGAGG	CCTCCTCTCCCTACACATGGG	1
CCATGTGTAGGGAGAGGAGGG	CCCTCCTCTCCCTACACATGG	1
CATGTGTAGGGAGAGGAGGGA	TCCCTCCTCTCCCTACACATG	1
ATGTGTAGGGAGAGGAGGGAT	ATCCCTCCTCTCCCTACACAT	1
TGTGTAGGGAGAGGAGGGATG	CATCCCTCCTCTCCCTACACA	1
GTGTAGGGAGAGGAGGGATGG	CCATCCCTCCTCTCCCTACAC	1
TGTAGGGAGAGGAGGGATGGG	CCCATCCCTCCTCTCCCTACA	1
GTAGGGAGAGGAGGGATGGGC	GCCCATCCCTCCTCTCCCTAC	1
TAGGGAGAGGAGGGATGGGCA	TGCCCATCCCTCCTCTCCCTA	1
AGGGAGAGGAGGGATGGGCAT	ATGCCCATCCCTCCTCTCCCT	1
GGGAGAGGAGGGATGGGCATT	AATGCCCATCCCTCCTCTCCC	1
GGAGAGGAGGGATGGGCATTT	AAATGCCCATCCCTCCTCTCC	1
GAGAGGAGGGATGGGCATTTT	AAAATGCCCATCCCTCCTCTC	1
AGAGGAGGGATGGGCATTTTG	CAAAATGCCCATCCCTCCTCT	1
GAGGAGGGATGGGCATTTTGC	GCAAAATGCCCATCCCTCCTC	1
AGGAGGGATGGGCATTTTGCA	TGCAAAATGCCCATCCCTCCT	1
GGAGGGATGGGCATTTTGCAC	GTGCAAAATGCCCATCCCTCC	1
GAGGGATGGGCATTTTGCACG	CGTGCAAAATGCCCATCCCTC	1
AGGGATGGGCATTTTGCACGG	CCGTGCAAAATGCCCATCCCT	1
GGGATGGGCATTTTGCACGGG	CCCGTGCAAAATGCCCATCCC	1
GGATGGGCATTTTGCACGGGG	CCCCGTGCAAAATGCCCATCC	1
GATGGGCATTTTGCACGGGGG	CCCCCGTGCAAAATGCCCATC	1
ATGGGCATTTTGCACGGGGGC	GCCCCCGTGCAAAATGCCCAT	1
TGGGCATTTTGCACGGGGGCT	AGCCCCCGTGCAAAATGCCCA	1
GGGCATTTTGCACGGGGGCTG	CAGCCCCCGTGCAAAATGCCC	1
GGCATTTTGCACGGGGGCTGA	TCAGCCCCCGTGCAAAATGCC	1
GCATTTTGCACGGGGGCTGAT	ATCAGCCCCCGTGCAAAATGC	1
CATTTTGCACGGGGGCTGATG	CATCAGCCCCCGTGCAAAATG	1
ATTTTGCACGGGGGCTGATGC	GCATCAGCCCCCGTGCAAAAT	1
TTTTGCACGGGGGCTGATGCC	GGCATCAGCCCCCGTGCAAAA	1
TTTGCACGGGGGCTGATGCCA	TGGCATCAGCCCCCGTGCAAA	1
TTGCACGGGGGCTGATGCCAC	GTGGCATCAGCCCCCGTGCAA	1
TGCACGGGGGCTGATGCCACC	GGTGGCATCAGCCCCCGTGCA	1
GCACGGGGGCTGATGCCACCA	TGGTGGCATCAGCCCCCGTGC	1
CACGGGGGCTGATGCCACCAC	GTGGTGGCATCAGCCCCCGTG	1
ACGGGGGCTGATGCCACCACG	CGTGGTGGCATCAGCCCCCGT	1
CGGGGGCTGATGCCACCACGT	ACGTGGTGGCATCAGCCCCCG	1
GGGGGCTGATGCCACCACGTC	GACGTGGTGGCATCAGCCCCC	1
GGGGCTGATGCCACCACGTCG	CGACGTGGTGGCATCAGCCCC	1
GGGCTGATGCCACCACGTCGG	CCGACGTGGTGGCATCAGCCC	1
GGCTGATGCCACCACGTCGGG	CCCGACGTGGTGGCATCAGCC	1
GCTGATGCCACCACGTCGGGT	ACCCGACGTGGTGGCATCAGC	1
CTGATGCCACCACGTCGGGTG	CACCCGACGTGGTGGCATCAG	1
TGATGCCACCACGTCGGGTGT	ACACCCGACGTGGTGGCATCA	1
GATGCCACCACGTCGGGTGTC	GACACCCGACGTGGTGGCATC	1
ATGCCACCACGTCGGGTGTCT	AGACACCCGACGTGGTGGCAT	1
TGCCACCACGTCGGGTGTCTC	GAGACACCCGACGTGGTGGCA	1
GCCACCACGTCGGGTGTCTCA	TGAGACACCCGACGTGGTGGC	1
CCACCACGTCGGGTGTCTCAG	CTGAGACACCCGACGTGGTGG	1
CACCACGTCGGGTGTCTCAGA	TCTGAGACACCCGACGTGGTG	1
ACCACGTCGGGTGTCTCAGAG	CTCTGAGACACCCGACGTGGT	1
CCACGTCGGGTGTCTCAGAGC	GCTCTGAGACACCCGACGTGG	1
CACGTCGGGTGTCTCAGAGCC	GGCTCTGAGACACCCGACGTG	1
ACGTCGGGTGTCTCAGAGCCC	GGGCTCTGAGACACCCGACGT	1
CGTCGGGTGTCTCAGAGCCCC	GGGGCTCTGAGACACCCGACG	1
GTCGGGTGTCTCAGAGCCCCA	TGGGGCTCTGAGACACCCGAC	1
TCGGGTGTCTCAGAGCCCCAG	CTGGGGCTCTGAGACACCCGA	1
CGGGTGTCTCAGAGCCCCAGT	ACTGGGGCTCTGAGACACCCG	1
GGGTGTCTCAGAGCCCCAGTC	GACTGGGGCTCTGAGACACCC	1
GGTGTCTCAGAGCCCCAGTCC	GGACTGGGGCTCTGAGACACC	1
GTGTCTCAGAGCCCCAGTCCC	GGGACTGGGGCTCTGAGACAC	1
TGTCTCAGAGCCCCAGTCCCC	GGGGACTGGGGCTCTGAGACA	1
GTCTCAGAGCCCCAGTCCCCT	AGGGGACTGGGGCTCTGAGAC	1
TCTCAGAGCCCCAGTCCCCTA	TAGGGGACTGGGGCTCTGAGA	1
CTCAGAGCCCCAGTCCCCTAC	GTAGGGGACTGGGGCTCTGAG	1
TCAGAGCCCCAGTCCCCTACC	GGTAGGGGACTGGGGCTCTGA	1
CAGAGCCCCAGTCCCCTACCC	GGGTAGGGGACTGGGGCTCTG	1
AGAGCCCCAGTCCCCTACCCG	CGGGTAGGGGACTGGGGCTCT	1
GAGCCCCAGTCCCCTACCCGG	CCGGGTAGGGGACTGGGGCTC	1
AGCCCCAGTCCCCTACCCGGA	TCCGGGTAGGGGACTGGGGCT	1
GCCCCAGTCCCCTACCCGGAT	ATCCGGGTAGGGGACTGGGGC	1
CCCCAGTCCCCTACCCGGATC	GATCCGGGTAGGGGACTGGGG	1
CCCAGTCCCCTACCCGGATCC	GGATCCGGGTAGGGGACTGGG	1
CCAGTCCCCTACCCGGATCCC	GGGATCCGGGTAGGGGACTGG	1
CAGTCCCCTACCCGGATCCCC	GGGGATCCGGGTAGGGGACTG	1
AGTCCCCTACCCGGATCCCCT	AGGGGATCCGGGTAGGGGACT	1
GTCCCCTACCCGGATCCCCTG	CAGGGGATCCGGGTAGGGGAC	1
TCCCCTACCCGGATCCCCTGG	CCAGGGGATCCGGGTAGGGGA	1
CCCCTACCCGGATCCCCTGGA	TCCAGGGGATCCGGGTAGGGG	1
CCCTACCCGGATCCCCTGGAG	CTCCAGGGGATCCGGGTAGGG	1
CCTACCCGGATCCCCTGGAGC	GCTCCAGGGGATCCGGGTAGG	1
CTACCCGGATCCCCTGGAGCC	GGCTCCAGGGGATCCGGGTAG	1
TACCCGGATCCCCTGGAGCCC	GGGCTCCAGGGGATCCGGGTA	1
ACCCGGATCCCCTGGAGCCCA	TGGGCTCCAGGGGATCCGGGT	1
CCCGGATCCCCTGGAGCCCAG	CTGGGCTCCAGGGGATCCGGG	1
CCGGATCCCCTGGAGCCCAGG	CCTGGGCTCCAGGGGATCCGG	1
CGGATCCCCTGGAGCCCAGGA	TCCTGGGCTCCAGGGGATCCG	1
GGATCCCCTGGAGCCCAGGAG	CTCCTGGGCTCCAGGGGATCC	1
GATCCCCTGGAGCCCAGGAGG	CCTCCTGGGCTCCAGGGGATC	1
ATCCCCTGGAGCCCAGGAGGG	CCCTCCTGGGCTCCAGGGGAT	1
TCCCCTGGAGCCCAGGAGGGA	TCCCTCCTGGGCTCCAGGGGA	1
CCCCTGGAGCCCAGGAGGGAG	CTCCCTCCTGGGCTCCAGGGG	1
CCCTGGAGCCCAGGAGGGAGG	CCTCCCTCCTGGGCTCCAGGG	1
CCTGGAGCCCAGGAGGGAGGT	ACCTCCCTCCTGGGCTCCAGG	1
CTGGAGCCCAGGAGGGAGGTG	CACCTCCCTCCTGGGCTCCAG	1
TGGAGCCCAGGAGGGAGGTGT	ACACCTCCCTCCTGGGCTCCA	1
GGAGCCCAGGAGGGAGGTGTG	CACACCTCCCTCCTGGGCTCC	1
GAGCCCAGGAGGGAGGTGTGT	ACACACCTCCCTCCTGGGCTC	1
AGCCCAGGAGGGAGGTGTGTG	CACACACCTCCCTCCTGGGCT	1
GCCCAGGAGGGAGGTGTGTGA	TCACACACCTCCCTCCTGGGC	1
CCCAGGAGGGAGGTGTGTGAG	CTCACACACCTCCCTCCTGGG	1
CCAGGAGGGAGGTGTGTGAGC	GCTCACACACCTCCCTCCTGG	1
CAGGAGGGAGGTGTGTGAGCT	AGCTCACACACCTCCCTCCTG	1
AGGAGGGAGGTGTGTGAGCTC	GAGCTCACACACCTCCCTCCT	1
GGAGGGAGGTGTGTGAGCTCA	TGAGCTCACACACCTCCCTCC	1
GAGGGAGGTGTGTGAGCTCAA	TTGAGCTCACACACCTCCCTC	1
AGGGAGGTGTGTGAGCTCAAT	ATTGAGCTCACACACCTCCCT	1
GGGAGGTGTGTGAGCTCAATC	GATTGAGCTCACACACCTCCC	1
GGAGGTGTGTGAGCTCAATCC	GGATTGAGCTCACACACCTCC	1
GAGGTGTGTGAGCTCAATCCG	CGGATTGAGCTCACACACCTC	1
AGGTGTGTGAGCTCAATCCGG	CCGGATTGAGCTCACACACCT	1
GGTGTGTGAGCTCAATCCGGA	TCCGGATTGAGCTCACACACC	1
GTGTGTGAGCTCAATCCGGAC	GTCCGGATTGAGCTCACACAC	1
TGTGTGAGCTCAATCCGGACT	AGTCCGGATTGAGCTCACACA	1
GTGTGAGCTCAATCCGGACTG	CAGTCCGGATTGAGCTCACAC	1
TGTGAGCTCAATCCGGACTGT	ACAGTCCGGATTGAGCTCACA	1
GTGAGCTCAATCCGGACTGTG	CACAGTCCGGATTGAGCTCAC	1
TGAGCTCAATCCGGACTGTGA	TCACAGTCCGGATTGAGCTCA	1
GAGCTCAATCCGGACTGTGAC	GTCACAGTCCGGATTGAGCTC	1
AGCTCAATCCGGACTGTGACG	CGTCACAGTCCGGATTGAGCT	1
GCTCAATCCGGACTGTGACGA	TCGTCACAGTCCGGATTGAGC	1
CTCAATCCGGACTGTGACGAG	CTCGTCACAGTCCGGATTGAG	1
TCAATCCGGACTGTGACGAGT	ACTCGTCACAGTCCGGATTGA	1
CAATCCGGACTGTGACGAGTT	AACTCGTCACAGTCCGGATTG	1
AATCCGGACTGTGACGAGTTG	CAACTCGTCACAGTCCGGATT	1
ATCCGGACTGTGACGAGTTGG	CCAACTCGTCACAGTCCGGAT	1
TCCGGACTGTGACGAGTTGGC	GCCAACTCGTCACAGTCCGGA	1
CCGGACTGTGACGAGTTGGCT	AGCCAACTCGTCACAGTCCGG	1
CGGACTGTGACGAGTTGGCTG	CAGCCAACTCGTCACAGTCCG	1
GGACTGTGACGAGTTGGCTGA	TCAGCCAACTCGTCACAGTCC	1
GACTGTGACGAGTTGGCTGAC	GTCAGCCAACTCGTCACAGTC	1
ACTGTGACGAGTTGGCTGACC	GGTCAGCCAACTCGTCACAGT	1
CTGTGACGAGTTGGCTGACCA	TGGTCAGCCAACTCGTCACAG	1
TGTGACGAGTTGGCTGACCAC	GTGGTCAGCCAACTCGTCACA	1
GTGACGAGTTGGCTGACCACA	TGTGGTCAGCCAACTCGTCAC	1
TGACGAGTTGGCTGACCACAT	ATGTGGTCAGCCAACTCGTCA	1
GACGAGTTGGCTGACCACATC	GATGTGGTCAGCCAACTCGTC	1
ACGAGTTGGCTGACCACATCG	CGATGTGGTCAGCCAACTCGT	1
CGAGTTGGCTGACCACATCGG	CCGATGTGGTCAGCCAACTCG	1
GAGTTGGCTGACCACATCGGC	GCCGATGTGGTCAGCCAACTC	1
AGTTGGCTGACCACATCGGCT	AGCCGATGTGGTCAGCCAACT	1
GTTGGCTGACCACATCGGCTT	AAGCCGATGTGGTCAGCCAAC	1
TTGGCTGACCACATCGGCTTT	AAAGCCGATGTGGTCAGCCAA	1
TGGCTGACCACATCGGCTTTC	GAAAGCCGATGTGGTCAGCCA	1
GGCTGACCACATCGGCTTTCA	TGAAAGCCGATGTGGTCAGCC	1
GCTGACCACATCGGCTTTCAG	CTGAAAGCCGATGTGGTCAGC	1
CTGACCACATCGGCTTTCAGG	CCTGAAAGCCGATGTGGTCAG	1
TGACCACATCGGCTTTCAGGA	TCCTGAAAGCCGATGTGGTCA	1
GACCACATCGGCTTTCAGGAG	CTCCTGAAAGCCGATGTGGTC	1
ACCACATCGGCTTTCAGGAGG	CCTCCTGAAAGCCGATGTGGT	1
CCACATCGGCTTTCAGGAGGC	GCCTCCTGAAAGCCGATGTGG	1
CACATCGGCTTTCAGGAGGCC	GGCCTCCTGAAAGCCGATGTG	1
ACATCGGCTTTCAGGAGGCCT	AGGCCTCCTGAAAGCCGATGT	1
CATCGGCTTTCAGGAGGCCTA	TAGGCCTCCTGAAAGCCGATG	1
ATCGGCTTTCAGGAGGCCTAT	ATAGGCCTCCTGAAAGCCGAT	1
TCGGCTTTCAGGAGGCCTATC	GATAGGCCTCCTGAAAGCCGA	1
CGGCTTTCAGGAGGCCTATCG	CGATAGGCCTCCTGAAAGCCG	1
GGCTTTCAGGAGGCCTATCGG	CCGATAGGCCTCCTGAAAGCC	1
GCTTTCAGGAGGCCTATCGGC	GCCGATAGGCCTCCTGAAAGC	1
CTTTCAGGAGGCCTATCGGCG	CGCCGATAGGCCTCCTGAAAG	1
TTTCAGGAGGCCTATCGGCGC	GCGCCGATAGGCCTCCTGAAA	1
TTCAGGAGGCCTATCGGCGCT	AGCGCCGATAGGCCTCCTGAA	1
TCAGGAGGCCTATCGGCGCTT	AAGCGCCGATAGGCCTCCTGA	1
CAGGAGGCCTATCGGCGCTTC	GAAGCGCCGATAGGCCTCCTG	1
AGGAGGCCTATCGGCGCTTCT	AGAAGCGCCGATAGGCCTCCT	1
GGAGGCCTATCGGCGCTTCTA	TAGAAGCGCCGATAGGCCTCC	1
GAGGCCTATCGGCGCTTCTAC	GTAGAAGCGCCGATAGGCCTC	1
AGGCCTATCGGCGCTTCTACG	CGTAGAAGCGCCGATAGGCCT	1
GGCCTATCGGCGCTTCTACGG	CCGTAGAAGCGCCGATAGGCC	1
GCCTATCGGCGCTTCTACGGC	GCCGTAGAAGCGCCGATAGGC	1
CCTATCGGCGCTTCTACGGCC	GGCCGTAGAAGCGCCGATAGG	1
CTATCGGCGCTTCTACGGCCC	GGGCCGTAGAAGCGCCGATAG	1
TATCGGCGCTTCTACGGCCCG	CGGGCCGTAGAAGCGCCGATA	1
ATCGGCGCTTCTACGGCCCGG	CCGGGCCGTAGAAGCGCCGAT	1
TCGGCGCTTCTACGGCCCGGT	ACCGGGCCGTAGAAGCGCCGA	1
CGGCGCTTCTACGGCCCGGTC	GACCGGGCCGTAGAAGCGCCG	1
GGCGCTTCTACGGCCCGGTCT	AGACCGGGCCGTAGAAGCGCC	1
GCGCTTCTACGGCCCGGTCTA	TAGACCGGGCCGTAGAAGCGC	1
CGCTTCTACGGCCCGGTCTAG	CTAGACCGGGCCGTAGAAGCG	1
GCTTCTACGGCCCGGTCTAGG	CCTAGACCGGGCCGTAGAAGC	1
CTTCTACGGCCCGGTCTAGGG	CCCTAGACCGGGCCGTAGAAG	1
TTCTACGGCCCGGTCTAGGGT	ACCCTAGACCGGGCCGTAGAA	1
TCTACGGCCCGGTCTAGGGTG	CACCCTAGACCGGGCCGTAGA	1
CTACGGCCCGGTCTAGGGTGT	ACACCCTAGACCGGGCCGTAG	1
TACGGCCCGGTCTAGGGTGTC	GACACCCTAGACCGGGCCGTA	1
ACGGCCCGGTCTAGGGTGTCG	CGACACCCTAGACCGGGCCGT	1
CGGCCCGGTCTAGGGTGTCGC	GCGACACCCTAGACCGGGCCG	1
GGCCCGGTCTAGGGTGTCGCT	AGCGACACCCTAGACCGGGCC	1
GCCCGGTCTAGGGTGTCGCTC	GAGCGACACCCTAGACCGGGC	1
CCCGGTCTAGGGTGTCGCTCT	AGAGCGACACCCTAGACCGGG	1
CCGGTCTAGGGTGTCGCTCTG	CAGAGCGACACCCTAGACCGG	1
CGGTCTAGGGTGTCGCTCTGC	GCAGAGCGACACCCTAGACCG	1
GGTCTAGGGTGTCGCTCTGCT	AGCAGAGCGACACCCTAGACC	1
GTCTAGGGTGTCGCTCTGCTG	CAGCAGAGCGACACCCTAGAC	1
TCTAGGGTGTCGCTCTGCTGG	CCAGCAGAGCGACACCCTAGA	1
CTAGGGTGTCGCTCTGCTGGC	GCCAGCAGAGCGACACCCTAG	1
TAGGGTGTCGCTCTGCTGGCC	GGCCAGCAGAGCGACACCCTA	1
AGGGTGTCGCTCTGCTGGCCT	AGGCCAGCAGAGCGACACCCT	1
GGGTGTCGCTCTGCTGGCCTG	CAGGCCAGCAGAGCGACACCC	1
GGTGTCGCTCTGCTGGCCTGG	CCAGGCCAGCAGAGCGACACC	1
GTGTCGCTCTGCTGGCCTGGC	GCCAGGCCAGCAGAGCGACAC	1
TGTCGCTCTGCTGGCCTGGCC	GGCCAGGCCAGCAGAGCGACA	1
GTCGCTCTGCTGGCCTGGCCG	CGGCCAGGCCAGCAGAGCGAC	1
TCGCTCTGCTGGCCTGGCCGG	CCGGCCAGGCCAGCAGAGCGA	1
CGCTCTGCTGGCCTGGCCGGC	GCCGGCCAGGCCAGCAGAGCG	1
GCTCTGCTGGCCTGGCCGGCA	TGCCGGCCAGGCCAGCAGAGC	1
CTCTGCTGGCCTGGCCGGCAA	TTGCCGGCCAGGCCAGCAGAG	1
TCTGCTGGCCTGGCCGGCAAC	GTTGCCGGCCAGGCCAGCAGA	1
CTGCTGGCCTGGCCGGCAACC	GGTTGCCGGCCAGGCCAGCAG	1
TGCTGGCCTGGCCGGCAACCC	GGGTTGCCGGCCAGGCCAGCA	1
GCTGGCCTGGCCGGCAACCCC	GGGGTTGCCGGCCAGGCCAGC	1
CTGGCCTGGCCGGCAACCCCA	TGGGGTTGCCGGCCAGGCCAG	1
TGGCCTGGCCGGCAACCCCAG	CTGGGGTTGCCGGCCAGGCCA	1
GGCCTGGCCGGCAACCCCAGT	ACTGGGGTTGCCGGCCAGGCC	1
GCCTGGCCGGCAACCCCAGTT	AACTGGGGTTGCCGGCCAGGC	1
CCTGGCCGGCAACCCCAGTTC	GAACTGGGGTTGCCGGCCAGG	1
CTGGCCGGCAACCCCAGTTCT	AGAACTGGGGTTGCCGGCCAG	1
TGGCCGGCAACCCCAGTTCTG	CAGAACTGGGGTTGCCGGCCA	1
GGCCGGCAACCCCAGTTCTGC	GCAGAACTGGGGTTGCCGGCC	1
GCCGGCAACCCCAGTTCTGCT	AGCAGAACTGGGGTTGCCGGC	1
CCGGCAACCCCAGTTCTGCTC	GAGCAGAACTGGGGTTGCCGG	1
CGGCAACCCCAGTTCTGCTCC	GGAGCAGAACTGGGGTTGCCG	1
GGCAACCCCAGTTCTGCTCCT	AGGAGCAGAACTGGGGTTGCC	1
GCAACCCCAGTTCTGCTCCTC	GAGGAGCAGAACTGGGGTTGC	1
CAACCCCAGTTCTGCTCCTCT	AGAGGAGCAGAACTGGGGTTG	1
AACCCCAGTTCTGCTCCTCTC	GAGAGGAGCAGAACTGGGGTT	1
ACCCCAGTTCTGCTCCTCTCC	GGAGAGGAGCAGAACTGGGGT	1
CCCCAGTTCTGCTCCTCTCCA	TGGAGAGGAGCAGAACTGGGG	1
CCCAGTTCTGCTCCTCTCCAG	CTGGAGAGGAGCAGAACTGGG	1
CCAGTTCTGCTCCTCTCCAGG	CCTGGAGAGGAGCAGAACTGG	1
CAGTTCTGCTCCTCTCCAGGC	GCCTGGAGAGGAGCAGAACTG	1
AGTTCTGCTCCTCTCCAGGCA	TGCCTGGAGAGGAGCAGAACT	1
GTTCTGCTCCTCTCCAGGCAC	GTGCCTGGAGAGGAGCAGAAC	1
TTCTGCTCCTCTCCAGGCACC	GGTGCCTGGAGAGGAGCAGAA	1
TCTGCTCCTCTCCAGGCACCC	GGGTGCCTGGAGAGGAGCAGA	1
CTGCTCCTCTCCAGGCACCCT	AGGGTGCCTGGAGAGGAGCAG	1
TGCTCCTCTCCAGGCACCCTT	AAGGGTGCCTGGAGAGGAGCA	1
GCTCCTCTCCAGGCACCCTTC	GAAGGGTGCCTGGAGAGGAGC	1
CTCCTCTCCAGGCACCCTTCT	AGAAGGGTGCCTGGAGAGGAG	1
TCCTCTCCAGGCACCCTTCTT	AAGAAGGGTGCCTGGAGAGGA	1
CCTCTCCAGGCACCCTTCTTT	AAAGAAGGGTGCCTGGAGAGG	1
CTCTCCAGGCACCCTTCTTTC	GAAAGAAGGGTGCCTGGAGAG	1
TCTCCAGGCACCCTTCTTTCC	GGAAAGAAGGGTGCCTGGAGA	1
CTCCAGGCACCCTTCTTTCCT	AGGAAAGAAGGGTGCCTGGAG	1
TCCAGGCACCCTTCTTTCCTC	GAGGAAAGAAGGGTGCCTGGA	1
CCAGGCACCCTTCTTTCCTCT	AGAGGAAAGAAGGGTGCCTGG	1
CAGGCACCCTTCTTTCCTCTT	AAGAGGAAAGAAGGGTGCCTG	1
AGGCACCCTTCTTTCCTCTTC	GAAGAGGAAAGAAGGGTGCCT	1
GGCACCCTTCTTTCCTCTTCC	GGAAGAGGAAAGAAGGGTGCC	1
GCACCCTTCTTTCCTCTTCCC	GGGAAGAGGAAAGAAGGGTGC	1
CACCCTTCTTTCCTCTTCCCC	GGGGAAGAGGAAAGAAGGGTG	1
ACCCTTCTTTCCTCTTCCCCT	AGGGGAAGAGGAAAGAAGGGT	1
CCCTTCTTTCCTCTTCCCCTT	AAGGGGAAGAGGAAAGAAGGG	1
CCTTCTTTCCTCTTCCCCTTG	CAAGGGGAAGAGGAAAGAAGG	1
CTTCTTTCCTCTTCCCCTTGC	GCAAGGGGAAGAGGAAAGAAG	1
TTCTTTCCTCTTCCCCTTGCC	GGCAAGGGGAAGAGGAAAGAA	1
TCTTTCCTCTTCCCCTTGCCC	GGGCAAGGGGAAGAGGAAAGA	1
CTTTCCTCTTCCCCTTGCCCT	AGGGCAAGGGGAAGAGGAAAG	1
TTTCCTCTTCCCCTTGCCCTT	AAGGGCAAGGGGAAGAGGAAA	1
TTCCTCTTCCCCTTGCCCTTG	CAAGGGCAAGGGGAAGAGGAA	1
TCCTCTTCCCCTTGCCCTTGC	GCAAGGGCAAGGGGAAGAGGA	1
CCTCTTCCCCTTGCCCTTGCC	GGCAAGGGCAAGGGGAAGAGG	1
CTCTTCCCCTTGCCCTTGCCC	GGGCAAGGGCAAGGGGAAGAG	1
TCTTCCCCTTGCCCTTGCCCT	AGGGCAAGGGCAAGGGGAAGA	1
CTTCCCCTTGCCCTTGCCCTG	CAGGGCAAGGGCAAGGGGAAG	1
TTCCCCTTGCCCTTGCCCTGA	TCAGGGCAAGGGCAAGGGGAA	1
TCCCCTTGCCCTTGCCCTGAC	GTCAGGGCAAGGGCAAGGGGA	1
CCCCTTGCCCTTGCCCTGACC	GGTCAGGGCAAGGGCAAGGGG	1
CCCTTGCCCTTGCCCTGACCT	AGGTCAGGGCAAGGGCAAGGG	1
CCTTGCCCTTGCCCTGACCTC	GAGGTCAGGGCAAGGGCAAGG	1
CTTGCCCTTGCCCTGACCTCC	GGAGGTCAGGGCAAGGGCAAG	1
TTGCCCTTGCCCTGACCTCCC	GGGAGGTCAGGGCAAGGGCAA	1
TGCCCTTGCCCTGACCTCCCA	TGGGAGGTCAGGGCAAGGGCA	1
GCCCTTGCCCTGACCTCCCAG	CTGGGAGGTCAGGGCAAGGGC	1
CCCTTGCCCTGACCTCCCAGC	GCTGGGAGGTCAGGGCAAGGG	1
CCTTGCCCTGACCTCCCAGCC	GGCTGGGAGGTCAGGGCAAGG	1
CTTGCCCTGACCTCCCAGCCC	GGGCTGGGAGGTCAGGGCAAG	1
TTGCCCTGACCTCCCAGCCCT	AGGGCTGGGAGGTCAGGGCAA	1
TGCCCTGACCTCCCAGCCCTA	TAGGGCTGGGAGGTCAGGGCA	1
GCCCTGACCTCCCAGCCCTAT	ATAGGGCTGGGAGGTCAGGGC	1
CCCTGACCTCCCAGCCCTATG	CATAGGGCTGGGAGGTCAGGG	1
CCTGACCTCCCAGCCCTATGG	CCATAGGGCTGGGAGGTCAGG	1
CTGACCTCCCAGCCCTATGGA	TCCATAGGGCTGGGAGGTCAG	1
TGACCTCCCAGCCCTATGGAT	ATCCATAGGGCTGGGAGGTCA	1
GACCTCCCAGCCCTATGGATG	CATCCATAGGGCTGGGAGGTC	1
ACCTCCCAGCCCTATGGATGT	ACATCCATAGGGCTGGGAGGT	1
CCTCCCAGCCCTATGGATGTG	CACATCCATAGGGCTGGGAGG	1
CTCCCAGCCCTATGGATGTGG	CCACATCCATAGGGCTGGGAG	1
TCCCAGCCCTATGGATGTGGG	CCCACATCCATAGGGCTGGGA	1
CCCAGCCCTATGGATGTGGGG	CCCCACATCCATAGGGCTGGG	1
CCAGCCCTATGGATGTGGGGT	ACCCCACATCCATAGGGCTGG	1
CAGCCCTATGGATGTGGGGTC	GACCCCACATCCATAGGGCTG	1
AGCCCTATGGATGTGGGGTCC	GGACCCCACATCCATAGGGCT	1
GCCCTATGGATGTGGGGTCCC	GGGACCCCACATCCATAGGGC	1
CCCTATGGATGTGGGGTCCCC	GGGGACCCCACATCCATAGGG	1
CCTATGGATGTGGGGTCCCCA	TGGGGACCCCACATCCATAGG	1
CTATGGATGTGGGGTCCCCAT	ATGGGGACCCCACATCCATAG	1
TATGGATGTGGGGTCCCCATC	GATGGGGACCCCACATCCATA	1
ATGGATGTGGGGTCCCCATCA	TGATGGGGACCCCACATCCAT	1
TGGATGTGGGGTCCCCATCAT	ATGATGGGGACCCCACATCCA	1
GGATGTGGGGTCCCCATCATC	GATGATGGGGACCCCACATCC	1
GATGTGGGGTCCCCATCATCC	GGATGATGGGGACCCCACATC	1
ATGTGGGGTCCCCATCATCCC	GGGATGATGGGGACCCCACAT	1
TGTGGGGTCCCCATCATCCCA	TGGGATGATGGGGACCCCACA	1
GTGGGGTCCCCATCATCCCAG	CTGGGATGATGGGGACCCCAC	1
TGGGGTCCCCATCATCCCAGC	GCTGGGATGATGGGGACCCCA	1
GGGGTCCCCATCATCCCAGCT	AGCTGGGATGATGGGGACCCC	1
GGGTCCCCATCATCCCAGCTG	CAGCTGGGATGATGGGGACCC	1
GGTCCCCATCATCCCAGCTGC	GCAGCTGGGATGATGGGGACC	1
GTCCCCATCATCCCAGCTGCT	AGCAGCTGGGATGATGGGGAC	1
TCCCCATCATCCCAGCTGCTC	GAGCAGCTGGGATGATGGGGA	1
CCCCATCATCCCAGCTGCTCC	GGAGCAGCTGGGATGATGGGG	1
CCCATCATCCCAGCTGCTCCC	GGGAGCAGCTGGGATGATGGG	1
CCATCATCCCAGCTGCTCCCA	TGGGAGCAGCTGGGATGATGG	1
CATCATCCCAGCTGCTCCCAA	TTGGGAGCAGCTGGGATGATG	1
ATCATCCCAGCTGCTCCCAAA	TTTGGGAGCAGCTGGGATGAT	1
TCATCCCAGCTGCTCCCAAAT	ATTTGGGAGCAGCTGGGATGA	1
CATCCCAGCTGCTCCCAAATA	TATTTGGGAGCAGCTGGGATG	1
ATCCCAGCTGCTCCCAAATAA	TTATTTGGGAGCAGCTGGGAT	1
TCCCAGCTGCTCCCAAATAAA	TTTATTTGGGAGCAGCTGGGA	1
CCCAGCTGCTCCCAAATAAAC	GTTTATTTGGGAGCAGCTGGG	1
CCAGCTGCTCCCAAATAAACT	AGTTTATTTGGGAGCAGCTGG	1
CAGCTGCTCCCAAATAAACTC	GAGTTTATTTGGGAGCAGCTG	1
AGCTGCTCCCAAATAAACTCC	GGAGTTTATTTGGGAGCAGCT	1
GCTGCTCCCAAATAAACTCCA	TGGAGTTTATTTGGGAGCAGC	1
CTGCTCCCAAATAAACTCCAG	CTGGAGTTTATTTGGGAGCAG	1
TGCTCCCAAATAAACTCCAGA	TCTGGAGTTTATTTGGGAGCA	1
GCTCCCAAATAAACTCCAGAA	TTCTGGAGTTTATTTGGGAGC	1
CTCCCAAATAAACTCCAGAAG	CTTCTGGAGTTTATTTGGGAG	1
